tweet	sentiment
New Post:  Samsung bestätigt Produktionsbeginn biegsamer OLED-Displays für 2012 ~http 	neutral
Base Lutea oder Samsung Galaxy Ace?  Ich hab die Qual der Wahl. Welches würdet ihr nehmen?	neutral
Jeden Tag ein neues Aktionsangebot - das Kenner-Tagesangebot vom 22. Juli 2011: Das Sony Alpha A390 Set: ~http 	neutral
Hör dir Katy Perry von Firework an! Ich habe den Song gerade mit TrackID™ von Sony Ericsson gefunden.	neutral
Dank @user geht es mir jetzt schon besser *_* &lt;3	positive
Lunett ~http	neutral
Noch Irgendwer; der den Grimm-Stoff aufgreift? Kommt da vllt eine neue Trendwelle? Zurück zu den Märchen; nur etwas aufgehübscht; moderner?	neutral
Dieses Video weitergeben -- Manfred Kriegel; 24 Stunden Hat Der Tag.MPG Fernfahrer - Song ~http  via @user	neutral
Urteil: Samsung darf Galaxy Tab nicht verkaufen ~http  #Apple #ipad #samsung #galaxypad #Patente #Monopol	neutral
zu Hause (:	positive
hab ein sony ericsson satio	neutral
Alle Freunde des Wintersports können sich freuen. Ab Freitag ist auch der Skilift am Pröller-Nordhang in Betrieb.... ~http 	neutral
Hallo Welt !	neutral
Okay der straßenbahnfahrer is besoffen Oo fährt rückwärts mit offen türen ... Hallo?	negative
#24hberlin erst ein bisschen Stream; dann einige Stunden publicviewing; dann Atom Demo; dann wieder pv; und seit 21h am pc - puuuuh	neutral
Frohe Weihnachten alle zusammen. Ich hoffe ihr lasst euch alle gut beschenken. Und habt ein schönes Fest.	positive
"“@JanSchmidt: sagt man eigentlich auch ""untige""; analog zu ""obige""?” kenne nur ""nebig"" - und das ist schon leicht schräg"	neutral
bin im r.l. besoffen; mir doch egal; was mit I.Steeger ist. püh.	neutral
Die @user und ich haben heute einen besonders tollen Platz zum lernen :) mit frechen Enten  ~http 	positive
Schlafen. || Morgen Arbeiten; dann Jule hier ^-^	positive
Videothek zwecks Abk. durch Hintereingang der 18+ Abteilung betreten.Interessant wie viele Rentner da rumhängen.Koronale Trainingsmaßnahme?	neutral
Lapidar beim Köpi Filmaward. Bitte voten und weiter sagen! ~http 	neutral
Caprica ist eine geile Serie! Schauen !	positive
Premium-Strategie = exzellente Produkte + Dienst-Leistungen hoher Qualität und überdurchschnittlicher Preise: Emotionen = Kauf-Entscheidung!	positive
neu bei twitter	neutral
Boa heute ist wieder nur assis im Zug Tag. Laut und es stinkt -____-	negative
Gute nacht ! Schlaft gut ihr alle!	positive
Microsoft-Apps für Symbian angekündigt: Nokias Kooperation mit Microsoft wird demnächst Früchte tragen: So solle... ~http 	neutral
Mein Audi TT hat Fronantrieb. Jupp; glaub ich Dir sogar.	neutral
Yeaaahh geil ; kanns kaum abwarten! Wann ist der realese ???RT @user am Freitag signing für den Re Release mit Sony von Blauer Samt	positive
War gestern das erste mal in einem Fitness-Studio. Hab eigentlich einen verdammt großen muskelkater erwartet; aber heute merk ich nichts :-D	positive
warum hat man das slidepad vom nintendo 3ds nicht blau; bzw. schwarz gelassen; sondern ist in der finalen version grau?	negative
Photo: Winterstiefel ADIDAS M Attitude Aus Veloursleder mit weichem Warmfutter (100% Polyester). Ferse mit... ~http 	neutral
Die Geschichte des Like Button! #Facebook ~http 	neutral
Gelbe Markierungen auf der Domänenstraße in Konz. Da steckt sicher der LBM dahinter. Ich erahne schon die nächste Baustelle für die Konzer!	negative
Kulturrampe Metal Night mit Rising Glory; Vanguard und Sacred Gate. Noch eine Band bisher geiler Abend	positive
Unser GM Achim Berg zu Entwicklungen in der ITK-Branche; Microsoft Geschäftsstrategie&Bedeutung der #CeBIT.... ~http 	neutral
Kreuzfahrt-Alternativen zu Ägypten und Tunesien bei Costa ~http  und Oceania ~http	neutral
Diabetes - Die unterschätzte Gefahr ~http  Sehr eindringlich!	neutral
Wir brauchen nicht zu prüfen;ob die ganze Arbeit ein Plagiat ist; sagte der praesident@uni-bayreuth.de ;sehen das alle so? #Guttenberg #fail	neutral
GPL: Wie muss der Quelltext angeboten werden?: Der Streit um mögliche Verletzungen der GPL durch Android-Geräte ... ~http 	neutral
"Weisheit des Tages: ""In der Kanalisation lebst der Kanaligator."""	neutral
Kopfsport Flashback #2: Daster und Menace am rappen; der Hofnarr wie immer am Beatschrauben und der Firsty am... ~http 	neutral
fährt jetzt ins Internat	neutral
Nur noch 2 Tage und dann ist wieder allseits bekannt; in Twistringen sind sie wieder alle Voll bis Oberkante Rand :D	positive
Austausch auf höchstem Niveau:: Eventprofis treffen sich im September in Luxemburg zum „1. European Event Summit“ ~http 	neutral
Ist das Samsung Galaxy S2 irgendwo ab Lager lieferbar??	neutral
Abverkauf Kabelsortiment - #20% auf alle #Proel Kabel ~http  (by ~mh) #20% auf alle #Proel Kabel	neutral
Ferienwohnung Stanici Omis *** MODERN ART *** Ferienhaus Unterkunft Urlaub ~http  via @user	neutral
Heute #WDR 5 #Zeitzeichen: 11. April 1936 Der Tod des Soziologen Ferdinand #Tönnies wird bekannt gegeben ~http  #Soziologie	neutral
Vorhin mit 5 Leuten die Sailor moon OP gesungen~ :3	neutral
Muss mal wieder ein Buch verkaufen; bitte helft mir. ~http	neutral
Heinz-Christian Strache   Telefon   +436643033839 #fpoe	neutral
Via Facebook wieder im Google-Index. ~http 	neutral
Ich bin auch 16 km gelaufen Waren mir 3 die einzigsten ?	neutral
Android News wurde gerade veröffentlicht! ~http  ▸ Titelthemen heute: @user @user @user @user	neutral
AJa guten morgen	positive
Gibt es eine Möglichkeit bei einem Benlux Modell von Samsung 46D6500 den Digitaltext (HBBTV) frei zu schalten ?	neutral
Darauf noch ein Schluck Wasser!	neutral
Meine Brille ist kaputt. Wie das passiert ist? Mir ist eine Wii auf den Kopf gefallen. Ja; eine Nintendo Wii.	negative
Du ziehst um? Wenn du Hilfe brauchst; sag mir bitte nicht Bescheid.	neutral
Wenn einen der Schmerz von innen auffrisst...	negative
Kleines rotes Tier lutscht am Daumen.	neutral
Aktuelles Urteil: Vorsicht beim Erwerb gebrauchter #Software - Hersteller darf #Schadensersatz fordern - ~http 	neutral
Komm zum Punkt! für Geschäftsleute als kostenlose Kurzversion zum Download: ~http 	neutral
New Post:  LG Smartphone mit Dualscreen und Split-Keyboard gesichtet ~http 	neutral
ufem weg nach zöri	neutral
Glühlampe brennt seit mehr als 100 Jahren: ~http	neutral
Einstweilige Verfügung gegen „Das Amt und die Vergangenheit“ – allerdings wirksam nur für zukünftige Auflagen ~http 	neutral
#1: Sony DCR-SX15EB SD Camcorder (50-fach opt. Zoom; 6;8 cm (2;7 Zoll) Display; bildstabilisiert) schwar... ~http  #kamera	neutral
Schnäppchenjäger aufgepasst: der #Kodak Multifunktionsdrucker #ESPC310 bei Media Markt im Angebot! ~http	neutral
Beides ist nicht schön. RT @user ich weiß nicht was ich machen soll... morgen wieder schule :(	negative
Oschersleben: Abt will den Sieg: Die Abt-Piloten wollen die Stärken des Audi A4 auf der Strecke in Oschersleben aus ~http 	neutral
Katzen Abendbrot gab es auch schon und schon wird wieder rumgelümmelt	neutral
Heute ab 15.00 Uhr spielen wir wieder Fußball (vor'm Schwimmbad) mit Freunden und Freundesfreunden. Wer will kann gerne kommen.	neutral
"Wie sicher ist die deutsche ""SwissID""? ~http "	neutral
Konfliktlösung für Männer: ~http  #notch #q3a  Haben wir damals auch gemacht. Dabei ging's allerdings eher ums Abwaschen.	neutral
Unser Team wächst: Die Medienwissenschaftlerin Juliane Lungershausen ist seit Anfang 2011 Junior Beraterin. ~http 	neutral
überall werbung zu sehen auch youtube o.O ich sags euch kauft nie microsoft produkte sie ziehen nur leute ab!!!!!	negative
ok ich fatz dann mal zum flegga	neutral
"Check out: ""Die Steinsuppe - oder: aus Wenig einen Erfolg machen"" ~http "	neutral
Social Media muss professionell werden - wenn ich sowas lese; kommt mir das Frühstück wieder hoch. Wir brauchen hier keine Drücker; Leute!	negative
Erinnerung: Unsere Jubiläumsaktion mit der Ihr 5% Extrarabatt auf alles erhaltet läuft nur noch bis Ende des... ~http	neutral
ach scheiße man mein laptop ist am arsch freu mich schon auf heute nach mittag!!! Miriam &lt;3	na
Es sind wieder viele stark reduzierte #Airsoft Vorführmodelle am Lager. Lieferung nur solange der Vorrat reicht! ~http	neutral
Linkbuilding Studienarbeit + Fallstudie veröffentlicht ~http  via @user	neutral
#Smartphone Schnäppchen von Nokia; HTC; Samsung und Sony Ericsson ~http 	neutral
Kanadas Bruttoinlandsprodukt fällt im zweiten Quartal zurück #kanada ~http 	neutral
Ich habe ein YouTube-Video kommentiert. ~http 	neutral
New Post:  Sony S1 & S2 Teaser Video veröffentlicht ~http 	neutral
Heut Abend: #Tatort: Der glückliche Tod ~http	neutral
Nie mehr ohne dich-ich liebe dich :-*	positive
Dürfen die das abgebrannte Sony-Warenhaus in London zeigen? Es enthält/enthielt ja schließlich Content von Sony Music Entertainment! #London	neutral
#Demner; #Merlicek und #Bergmann gewinnen Corporate #Werbeetat Pitch von #OMV //mg	neutral
Audi wähnt sich noch nicht in Sicherheit: Martin Tomczyk ist seit Brands Hatch DTM-Spitzenreiter; doch bei Audi wei ~http 	neutral
Google kauft Patente von IBM ein ~http 	neutral
Bei Les Mads suchen sie eine neue Bloggerkollegin und Jaokob von Dandy Diary verrät; wer seine Favoritin ist.... ~http 	neutral
Pics on: ~http	neutral
Argh; all die Videospiel-News allein zu posten ist echt nervig und anstrengend! Helft mir bitte und meldet euch im Nintendo Gamer Forum!!!	negative
Gerade gehört: Ein #Atom verhält sich zu einer Orange; wie eine Orange zur Erde	neutral
Keine Lust mehr DX Ich waere fast in Braunschweig stecken geblieben &gt;&gt;	negative
Playstation Network passwort wieder gefunden =)	positive
Liebe Freunde; bitte stimmt bei der funny-frisch Chips-Wahl 2011 für mich als Chips-Tester! ~http 	neutral
Twee Free wird im Juli aus dem App Katalog entfernt. Eine Twee2 Testversion ist derzeit nicht geplant #webos #palm #pre #pixi	neutral
#DdoKwn:  Mit einem Taschenmesser; Bindfaden & Büroklammer kann man Bomben bauen; Reaktoren reparieren & Sicherheits- systeme lahm legen	neutral
Finest-Electronic-Beats Klangraum NÜRNBERG / FÜRTH 106;5 MHz - ERLANGEN 106;2 MHz KABEL DEUTSCHLAND 103;9 MHz - KABEL… ~http 	neutral
Verewige dich unter ~http  als Kapitän der Fußball Nationalmannschaft in einem von 2000 exklusiven adidas SPORT 2000 Superpostern!	neutral
Fronius und Linde zeigen gemeinsamen Brennstoffzellen-Schlepper ~http	neutral
"Ein Angestellter in einer sehr großen Firma nimmt das Telefon; wählt und sagt: ""Mein Schatz; heb deinen süßen ...~http "	neutral
Beim #10. #Cello #Festival wird es an 3 Tagen #öffentl. #Workshops geben; geleitet u.a. von  #Maria #Kliegel; #Natalia #Gutman; #Arto #Noras	neutral
"now @user am Set von ""Der Deutsche Freund""  mit Max Riemelt uvm.... ~http "	neutral
Adobe Illustrator - Grundlagen: 3D-Werkzeuge in Illustrator - PSD-Tutorials.de ~http  via @user	neutral
Tramparty Zürich ~http 	neutral
Die Online-Wunschliste nur hier mitmachen! ~http 	neutral
Ich hab kleine Füße und trotzdem große Titten.	neutral
experiment: wildleder in der waschmaschine.	neutral
Vermisse sie einfach. aber trau mich nicht es ihr mal zu sagen.	negative
Schüchternheit ist nicht gefragt ~http 	neutral
#Bad Ems hat soviel Flair wie ne Scheibe Toastbrot.	negative
Ich habe 2 Fotos im Album „~ Konzerte ~“ auf Facebook gepostet ~http 	neutral
Die nächste Party steht an und Sie wissen nicht; was Sie mitnehmen sollen? Schenken Sie doch eine Flasche Echte... ~http 	neutral
"für alle die es nicht wissen wollen: ""knurd"" heißt ""drunk"" auf rückwärts; das heißt; dass man erst mal eine Flasche Wein trinken muss; ..."	neutral
Viacom verliert vor Gericht gegen Google ~http 	neutral
hab grad dein Trailer gesehen zu deiner Sendung auf einsfestival. Huhu ich freu mich schon :D. Kommt des jeden Donnerstag?	positive
Jungs; die mit den Fan-Postern ihrer Mädels konkurrieren wollen; werden nicht umhin kommen; Robs verwegenen Style zu klauen.	neutral
Freut sich auf Ihren Sony Ebook Reader!	positive
"#Bispingen. Heute ist ""Sturzfest""!!!!!!~http "	neutral
Nach Daimler und Opel will auch Audi Brennstoffzelle ~http 	neutral
via/ @user Immobilienangebot: chice 2 Zimmer #Wohnung in #Dresden Kleinzschachwitz; absolut ruhig und elbnah; 62 m²  ~http	neutral
Philippe Courard im Gespräch: 80 Millionen Arme in der EU ~http 	neutral
"Rhein-Neckar Zeitung - Politik trifft Jugend - Dann steht ein Schüler im ""Piraten-Partei""-T-Shirt auf und fragt..- ~http "	neutral
Brainstorming (päd. auch Thesengarten genannt ;-)) zum Thema Kinder- und Jugendstufe #kjgdk	neutral
Von einem ganz ungefährlichen Pferdevirus - mz-web.de ~http	neutral
Das LLR Outfit für den heutigen Tag! #Bday #3Jahre ^JO ~http 	neutral
Gabriel will Langzeitarbeitslosen helfen. Selbstzweck oder Nächstenliebe?	neutral
BGH-Entscheidung zur Rückforderung schwiegerelterlicher Zuwendungen ~http	neutral
Schlägt am 5. November die letzte Stunde von Facebook? ~http 	neutral
So; noch ein letztes mal alleine schlafen; dann hab ich endlich @user wider *freu*	positive
Female-Resources: Das war die 43. Kalenderwoche: #Frauen - #Wirtschaft - #Politik ~http 	neutral
Ich will ein Samsung Galaxy S2 bei Androidsforum.de gewinnen! Gewinnspiel auf ~http	neutral
Herr Holm ist alt geworden.. Und immer noch nicht witzig!	negative
steinofen flammkuchen käse lauch.. beste was grade geht.. lecker lecker lecker.. (:	positive
"Bald kommt mein bestelltes Spiel an. ""Naruto S. Ultimate Ninja Sotrm 2"" Ich freu mich schon. Ich wills jetzt schon haben."	positive
Boho; Hippie und Ethno Styles - Geschichte + Styling Tipps - ~http 	neutral
Blogartikel Yasni: Medienwelt wird aufmerksam ~http 	neutral
Aufsteiger Platz #1: Nike Swoosh stirnband ~http 	neutral
So ganz unrecht hat er nicht.	neutral
der Wortkünstler  hält uns auf dem laufenden. RT @user Heute geht ramadan los !	neutral
So; für alle Interessierten; ich habe eine Mail vom Samsung Kundenservice/Support erhalten mit folgendem Inhalt (vielle ~http 	neutral
Palatschinken und Topfencreme mit Brombeer-Balsamico-Ragout ~http  @user #rezept #kochen #lecker #rezepte #dessert	neutral
“Abmahnung” per Email von APW ist ein Fake: Wer in diesen Tagen eine angebliche Abmahnung per Email von den Rech... ~http 	neutral
Glückwunsch #SPD Lehrte: katastrophale Zustände im neuen #OBI. Aber das stört dich ja schon länger nicht mehr. ~http 	negative
Nicht nur was für Highspeed-Leser; Leseratten; Weihnachtsmäuse und sonstige Boandlkramer: ~http 	neutral
! Persermix sucht neues zu Hause in Krefeld: Verschmuster Weiss-Roter Kater ca. 9 Wochen sucht... ~http  ~http	neutral
Angeschlossen und klingt einfach nur fett :) #Teufel	positive
Kantoos Economics - Yglesias sagt wie es ist: Das Problem an QE ist nicht das ; sondern das ~http 	neutral
Für all das; was ich fühle; wird es niemals die passenden Worte geben.	na
[Gerücht] Nozomi: Sony Ericssons neues Flaggschiff: Offenbar wird bald ein neues Flaggschiff von Sony Ericsson i... ~http 	neutral
Exklusive Eigentumswohnung mit Fahrstuhl Wohnung; 26123 Oldenburg-Donnerschwee Kaufpreis: 246.500 €; Baujahr: 2011… ~http	neutral
musik hören und gitarre spielen :)	positive
Gewinnspiel: Dead or Alive Dimensions sucht einen Gewinner! - Planet3DS.de - Nintendo 3DS News: ~http  via @user	neutral
Folgt ihr @user #ff	neutral
vor 12 stunden lagen wir noch zusammen am strand. ach man :/	negative
Kann man im Januar nach Bali fliegen? ~http 	neutral
Kleinanzeigen kostenlos bundesweit inserieren ~http 	neutral
So Ihr Lieben! Ich wünsche euch einen guten Rutsch ins neue Jahr! Feiert schön und macht nichts; was ich nicht auch bereuen würde ;-))	positive
Jetzt wärs noch toll; wenn mein Samsung Galaxy sII morgen oder am Samstag noch kommen würde...	neutral
Handle jetzt! Nutze diese einmalige Chance; um mit Riesenschritten voranzuschreiten. Revolutioninäres neues System ~http	neutral
Für alle Samsung Galaxy I9000 Besitzer: Ab heute könnt ihr via Kies offiziell auf 2.3.3 updaten	neutral
Spezial zur IFA: Microsoft Office Professional Plus 2010 für 59;90 Euro ~http 	neutral
habe seit heute einen mac book pro zu hause stehen :-) liebe ihn	positive
Die passende Strategie für Microsoft Office 365 ~http  via @user #Avanade	neutral
#Flamenco ist unhabhängig von Kostüm und Aussehen. HIer der ~http	neutral
Ah... Gary Oldman ist in dem Film so ein Ekel....	negative
Die 'Harry Potter'-Stars früher und heute‎ ~http 	neutral
(Deswegen ist mir mein Bio-Lehrer sehr sympathisch ;D)	positive
! Tischplatte aus Echtholz in Krefeld: Eigenbau; lackiert; geringfügige Beschädigungen an zwei... ~http  ~http 	neutral
Interessante Mitteilungen in der Sache Apple vs. Samsung in Düsseldorf: @user	neutral
Das letzte goldene Ei hatte sich bei der Samsung HMX-Q10 Schwarz versteckt.	neutral
Flucht durch das Fenster - Barmbek: Frau (26) in Stacheldraht-Gefängnis gefangen gehalten! ~http	neutral
Die Marke #Durex bekommt einen neuen Besitzer. Wer weiß; was dann wird - deshalb jetzt sofort Panikkäufe starten! ~http 	neutral
Spartakus auf RTL	neutral
#Gewinnspiel: Samsung Galaxy S II - ~http  #Schweiz	neutral
Sind Arbeitszeugnisse wertlos?      ~http                         #CallCenter #Teamleiter ~http 	neutral
Kennt Ihr unsere neuen Helden schon? Nein?! Dann schaut sie Euch mal an; denn mit ihrer Hilfe könnt Ihr ab jetzt... ~http	neutral
und @user machen sich gerade mit  nate dogg und Area Codes ready für booooooooooooooooom bap! Pb`s @user finest legt auf...	neutral
Schutz vor dubiosen Firmen- ~http 	neutral
Apple gegen Samsung - Erneut manipulierte Bilder bei Klage verwendet ~http  via @user	neutral
Kann man Domains bei #Strato mit Microsoft Office 365 (#BPOS) nutzen? Es scheint; als könnte man die NS-Records nicht ändern. :-(	negative
Preiskampf um Roaming-Tarife - Verkaufs-Charts der Smartphones: Apple iPhone 4 und Samsung Galaxy S führen. ~http	neutral
Manchen Leuten folge ich nur aus @user. Höhöhö. Total witzig und neu. Gerade frisch ausgedacht. Gab's noch nie!	positive
Causa Apple Inc. vs. HTC: Rollt jetzt der Lizenzrubel? ~http 	neutral
Apple vs. Samsung LG Düsseldorf: Verdacht auf inkorrekte Seitenverhältnisse bei Beweisfotos ~http 	neutral
ich weiß nich...die große Twitter zeit ist vorbei..bin eher am Fasebooken..	neutral
Das Niveau hat mal wieder abgesagt...ab mit dem Kopf!	negative
„Ich beschäftige mich nicht mit dem; was getan worden ist.  Mich interessiert; was getan werden muss.“   Marie Curie	neutral
"Einzelkind hört sich komisch an. ""Alleinerbe"" finde ich besser"	neutral
was @user heisst? Ganz easy: Deutschlands weltbestes Dossier; Leute!	neutral
Hi Gays; ist euch auch so schwül heute?	neutral
dann gibts da noch die menschen; die sich einfach mal gar nich mehr melden und man sich fragt; was das eigentlich soll u_u	negative
Veranstaltung: Medellin’s International Jazz Festival: Schedule ~http  #Kolumbien #Jazz #Südamerika	neutral
Ich glaube nichts; ich glaub an dich; glaubst du an mich; ich glaub ich auch.	neutral
Nintendo gewinnt Rechtsstreit mit BigBen um Wii-Remote: BigBen; auf jeder Konsole bekannt für ihre günstigeren A... ~http	neutral
Comment on NRW: Erdbeben der Stärke 4;4 by Florian: In Marl war es auch deutlich zu spüren!     ~http 	neutral
eBooks mobil kaufen & lesen: Ab sofort gibt's die Libri.de eBookS App für Samsung Smartphones und Samsung Tablets ~http 	neutral
Das sagt der #Focus zum #Schimanski #Tatort ~http 	neutral
Wird beim Islam-Studiengang an der Uni Tübingen dann türkisch gesprochen?	neutral
Markteinführung: Samsung Galaxy Note kommt im Oktober 2011 ~http  #Samsung #GalaxyNote #Smartphone	neutral
Ehrlich ey. schon wieder keinen Bock mehr. &gt;_&gt; Wie kann man so verblendet sein?	negative
Anastasia? Aguilera? Kann mich bei Naja Maja! nicht entscheiden #esc	neutral
Läd sich gerade die 10 NES Spiele des Nintendo Ambassador Programmes herunter.	neutral
Saxophon - ~http  Informationen und wissenswertes Ã¼ber das #Saxophon (by ~Danyel)	neutral
Bin auf der Suche nach dem günstigsten Preis für den Samsung 40LE-B650. Bin bei 769€ Bei unter 750€ schlag ich zu!	neutral
Hatte einen wunderbaren Abend.. :)	positive
"Read my response to ""Wähle: Karneval in Venedig oder Polarforschungsschifffahrt?"": ~http "	neutral
Morgen nach der Arbeit zu Dodo (:	positive
Trotz Apple-Klage: Samsung Galaxy Tab 10.1 bei Vodafone erhältlich ~http  via @user	neutral
Joschka Langenbrinck #SPD ~http  #Statement #Berlin #Mobbing	neutral
Weil´s Spaß macht! #ff @user @user @user @user @user @user	positive
Zurück in Düsseldorf - war klar dass das Wetter schlecht ist...	negative
Der morgen ist da und was ist? Einer der Akkus geht wieder! :-)	positive
Jetzt nur noch Einleitung und Schluss schreiben	neutral
Mhhh; wüüünderschööönes Wochenende!!! ♥	positive
Gleich gehts nach Hannover zum Einkaufsbummel. Freu mich schon; war schon ewig nicht mehr in Hannover :)	positive
MARANXA-deutsch /////////////////////////////////////////// Es gibt mehr... Posted: 29 Aug 2011 11:46 PM PDT http:.. ~http 	neutral
allen einen wunderschönen guten morgen. geniest den tag und Gönnt euch selber oder euren Liebsten was. ~http 	positive
Kann mir jemand sagen wo ich ein Samsung Galaxy S2 am schnellsten herbekomme? Evtl. Auch aus dem Ausland?	neutral
Neuer #Münster #Tatort: Boerne und Thiel drehen am Kanal und an der Uniklink ~http 	neutral
Mein neuestes Hobby: Im Frankentipps-Ticketsystem die ausgefallensten Saalpläne als Szenarientest anlegen;-) Macht Spaß!	positive
Firefox 7 Beta 2 veröffentlicht: Nach etwas mehr als einer Woche gibt es nun die Beta 2 von Firefox 7 zum Downlo... ~http 	neutral
Fuzzy-Logik: Verallgemeinerung der griechischen ODER-Logik; unscharfe Mengen-Zugehörigkeiten (unscharfe Mengenlehre): Systemische UND-Logik!	neutral
#Jobs KFZ- Mechaniker (m/w): Mit durchschnittlich rund 63.000 Mitarbeitern und 500 Niederlassungen in rund 300 S... ~http 	neutral
Meine Woche auf Twitter: 1 Retweets erhalten; 1 Erwähnungen. Via: ~http 	neutral
neidhardt frühstücken gehen...  wird lustig wenn julian ma aufsteht!!	na
Ich habe ein YouTube-Video zu meinen Favoriten hinzugefügt. -- Rube Goldberg Machine i... ~http 	neutral
#Sprache #lernen Weitere Infos zu ** Polnisch ** Vokabeltrainer für #Gastro & #Tourismus finden Sie hier &gt;&gt; ~http 	neutral
Was für eine Aussicht! ~http 	positive
Guten Morgen liebe Sorgen; seid ihr auch schon alle da. Habt ihr auch so gut geschlafen? ~http 	neutral
yeeeah hab mir cooking mama gekauft :D	positive
Sicherheitsdialoge werden in Windows 8 reduziert: Wie Microsoft in einem älteren Blogbeitrag zu Windows 8 erwähn... ~http 	neutral
freut sich über seinen neuen sony vaio	positive
Es gibt ja verschiedene Bänke ... oder Banke ... Banks	neutral
gefällt Seit Vorgestern von Feinkost bei Ping ~http  #iTunes	neutral
Ich stolperte über die Verwechslung von BuKo (Bundeskongress) mit BuKo (Frischkäse).  Imo is Frischkäse aber auch unwichtig! #BuKo #Julis	neutral
Tagesstatistik: 302 neue Beiträge; 16 neue Themen; 3 neue Galeriebilder! Verpasst? ~http 	neutral
Lichtgestalter Aachen: ~http	neutral
Jetzt kostenlos Soldat werden auf @user ~http	neutral
Bin wieder zu Hause und versuche; mich an mein neues Handy zu gewöhnen. Kennt sich jemand mit Samsung aus?	neutral
"Die Ausstellung ""Die Dracula-Legenden"" wird am 18.06. in Mirow im Unteren schloss eröffnet (Öffnungszeit: 10-18 Uhr). ~http "	neutral
#WHS News: Phone Connector für WHS 2011 veröffentlicht: Microsoft hat gestern den “Windows ... ~http  @user #NAS	neutral
11 Stunden geschlafen... oO wow!	neutral
Marktmusikkapelle Schwanberg online. ~http 	neutral
"Übermorgen kann ich schon sagen: ""morgen gehts endlich nach hause zur tollsten frau der welt!"" *träum*"	positive
Turnschuhe für die Dritte Welt. Adidas kooperiert mit Nobelpreisträger Muhammad Yunus. Quelle: TextilWirtschaft	neutral
alle 24 minuten ging 2008 an den aktienmärkten rechnerisch eine Milliarde Dollar verloren.	neutral
Als weiteren Angriff gegen Nordkoreas Militärs hat #Apple #Lion das Launchpad eingebaut. Sozusagen dumbfire action...	neutral
Auf geht's Werder kämpfen und siegen!	positive
Ich möchte einen Lexmark All-In-One-Drucker bei @user gewinnen: ~http  #TechDepot	neutral
Trainingslehrgang  in Freital bei Dresden mit  JKA Karate Instructor Julian Chees (5.Dan) mehrfacher Kata Weltmeister & Deutscher Meister	neutral
Haha das ist wirklich nur noch Kindergarten! Wie lächerlich! xD Dumme; unreife Kinder.	negative
Erneut abgetrennter Fuß in Kanada angeschwemmt #kanada ~http 	neutral
Na bumm - Hitler nicht mehr Ehrenbürger in Amstetten: ~http 	neutral
Kostenloses Jomsocial 2.2.x Sprachpaket aktualisiert auf Knuddelesel.de ~http 	neutral
Kostenlose VHD-Images für Microsoft Virtual PC: Benutzer von Windows 7 bekommen mit Microsoft Virtual PC die Mög... ~http 	neutral
#Holzwickede SG Holzwickede: Sommerfest bietet Spiel und Spaß ohne Grenzen: Nur noch zweimal schlafen und der Sp... ~http 	positive
wie wird nun eigentlich das iPhine 5 aussehen ohne #SteveJobs????	neutral
TV-Show in Frankreich stellt Milgram Experiment nach. ~http	neutral
Mein Fresse blutet ohne dass ich eins aufs Maul bekommen hab .. Das soll mir mal einer nachmachen	negative
Der Sieger unseres Deployment Hero Contest; den wir zusammen mit Microsoft durchgeführt haben; steht fest! ~http 	neutral
Nokia und Microsoft attackieren die Alleinherrschaft von RIM via It-business ~http 	neutral
Der goldene Spatz ~http	neutral
Eine gute Nachricht gibt es noch: Mein Schnupfen ist verflogen! *__*	positive
Fotos Bilder sofort für Ihre Werbung PR Publikation die besten hier ~http 	neutral
Katja Kullmann als Identity Theft Opfer bei Facebook: ~http	neutral
Neue Produkte von Samsung im Kommen! Teil 1 ~http 	neutral
;) ~http  Wahrscheinlich einer der bekanntesten Freizeitschuhe Produzent Gucci gucci	neutral
Unterricht ohne Lehrer ist toll. &lt;3	positive
Wichtige Hinweise zum Thema Personalienfeststellung: ~http  ~http  #s21	neutral
Lieber frohe Ostern als ein mieser Western!	neutral
Wahlergebnispräsentation Kreis #Kleve; #Wesel; usw. -&gt; ~http  ; wird idR. laufend während der Auszählung aktualisiert!	neutral
Wie ich einfach schon wieder kotzen könnte. Und heulen. Am Besten abwechselnd. Scheiße.	negative
ich brauch ganz viel motivation um jetz nicht todesmüde ins bett zu fallen!!!!  FREIWILLIGE VOR !!!!!	neutral
Coach statt Couch ~http  #Mobbing #Mobbingberatung #Kassel	neutral
"Freihaltebedürftig? RT @user Netzwelt-Ticker: Microsoft will Apples ""Appstore""-Marke löschen ... ~http "	neutral
jetzt schnell Musik hören bovor ich richtig schlechte laune bekomme!	negative
Oh noez! Microsoft kauft Skype. Übermorgen geht die Welt unter.	negative
Kanada: Doppeltitel für Thiem bei der US-Open-Generalprobe #kanada ~http	neutral
Ich empfehle: Erklärung meines Telefonverhaltens ~http 	neutral
Wie Sie ohne Investitionen einen Kapital von € 32;500; - erhalten können; finden Sie auf ~http  *** Bitte notieren Sie BIG_7843	neutral
Sport: Real Mallorca fliegt zu einem Freundschaftsspiel am 27. Mai nach Kolumbien ~http 	neutral
Neue Panne: Sony legt Kundendatensätze selbst offen - Golem.de ~http  #endless #story #sony #fail	neutral
Gibt's da nichts von Ratiopharm? #Frauentausch	neutral
Ich habe den Kanal von HDHomerJ auf YouTube abonniert (~http ).	neutral
Falls wer die hölzerne @user findet; nicht mit Säge o.ä. bearbeiten sondern großflächig mit Kaffee einreiben. Fertig ist Kaffee Latte.	neutral
Denkt bei euren Web-Sites an die Lesbarkeit - auch der älteren Internet-Anwender. Sonst kaufen die woanders!	neutral
Heute leg ich einen Martha Stewart Tag ein :) Wer will Tiramisu??	positive
#WHS News: Diskeeper 2011 bald für Windows Home Server 2011 erhältlich: Laut der englischsp... ~http  @user #NAS	neutral
Hatte gestern einen schönen Geburtstag :)	positive
ER macht mich aggressiv...	negative
Bald bei Kliomedia: Glasproduktion. Archäologie und Geschichte: ~http  #glas #mittelalter #glashütten #archäologie	neutral
Ein Lebenszeichen von Kittie auf meinem #Blog ~http 	neutral
hahahaha... xD xD xD... ich lach mich tot.. schön das man mir auf diese art und weise ein lächeln ins gesicht zaubern kann.. xD xD xD haha..	positive
Gewinnspiel auf @user - Als Gewinne winken ein Samsung Full-HD LED 3D Fernseher und iPads! #gewinnspiel	neutral
Dieser Domscheit-Berg ist so ein asozialer Spinner...	negative
64GB Ipodtouch = 400 € und 32GB Ipodtouch 300€	neutral
20:30 Uhr Licht aus	neutral
Familienurlaub am Achensee und vor dem Frühstück die ersten 10km gejoggt. #trainingslager	neutral
Frühstück & Brunch: Rezepte; Tipps und Warenkunde - von Hannes Finkbeiner et al. - Matthaes. ~http 	neutral
Wo yao feng le.	na
So funktioniert ein Touchscreen ~http 	neutral
Netzwerk-Mediaplayer Sony SMP-N100 für 75;90 Euro bei iBOOD ~http 	neutral
Das nenne ich ganz schön Mutig erst holt man einen der sanieren soll und will mit den großen Hunden pinkeln und dann keinen Arsch inne Hose	negative
Frühling ist da!!!!! und es gibt grad nichts schöneres als Sonne	positive
morgen pulp ja oder nein? .grübel.	neutral
Soooo auf geht's Löwen kämpfen und siegen :)) (@ Eissporthalle Neuss) ~http 	positive
Heute #lateline anrufen? Vielleicht.	neutral
haltet diese Gruppe auf : ~http 	neutral
Mutti beim Elternabend.	neutral
#ff Liebe installieren:  ~http 	neutral
Allerlei Verbesserungen : Microsoft zeigt Details des Internet Explorer 10 ~http  #N24	neutral
heute nachmittag gabs einen leckere bio burger... :) ~http 	positive
Immer wenn irgendwer Wanne Eickel erwähnt muss ich an @user denken :/	neutral
2001: Odyssee im Weltraum: Samsung holt Hilfe aus dem All ~http 	neutral
Heute gehts shoppen !!! Wir bringen Mama´s Kreditkarte zum glühen; oder nicht ??? Mal sehen !!!	positive
Letzte Chance: Sprachkurse zum Sparpreis *Auf alle EXPRESSKURSE gibt's 10 € Rabatt. &gt;&gt;  ~http  #Sprachen #lernen #Reis	neutral
Und heute lag der Frosch vor meiner Tür!Er war Tod.Tod Zerquetscht!Wer dahinter steckt is unbekannt.Die Freiheit ist schon lange Tod Freunde	negative
Marken-Umfrage: Sony beliebter als Apple @user ~http 	neutral
.. Frittenbude ist schon geil. (: &lt;3'	positive
Such den Fehler @user  ~http 	neutral
#inappropriatefuneralsongs Wunder gibt es immer wieder ...	neutral
Kann mir jm. sagen wer mich eben bei der Unterführung bei der ETS in nem blauen Audi KB.JB... gegrüßt hat? :D	neutral
Guten Tag an diesem herrlichen Freitag	positive
"Kaum hat Microsoft Skype gekauft ... ""+"" wie neuer Kontak bringt ein Submenü für Neu ODER Suchen. Erinnert mich an Start -&gt; Beenden #iPad"	neutral
In einem Meer voll Schmerzen; ertrinken die einen; die anderen lernen darin zu schwimmen..'	neutral
der Vertrag läuft bis 2015 RT @user ~http  ist Generalübernehmer der Berliner #Ampelschaltung	neutral
Bericht in Fachzeitschrift ~http 	neutral
Neu auf KL: 11. Filmkunstmesse | 19.-23.09.2011: Vom 19. bis 23. September 2011 treffen sich über 900 Kinobetrei... ~http 	neutral
Die Frisur passt auf jeden Fall zum Text. #Lena #ardesc	neutral
Nach ADC Silber und Cannes Silber freuen wir uns über GOLD beim ADC Europe für die MB Sprinter-Bewerbung. ~http  ^JO	positive
Das Foto Konijnenberg Kenner-Angebot: Die Sony DSC-HX100 aktuell versandkostenfrei für nur € 469;00: ~http 	neutral
LiebeEltern.de - Für eine sichere Zukunft Ihrer Kinder auf Facebook ~http 	neutral
Kleiner Ausflug auf die andere Rheinseite: verkaufsoffener Sonntag auf dem #Stadtfest in #Wiesbaden ~http 	neutral
Drastische Source Code Änderungen sind geplant beim Video Addon.Anregung durch User Raystar. Ein Player für alle Formate.Das heißt Arbeit :P	neutral
helft @user Ist jemand aus Richtung München/Nürnberg/Regensburg am #dcc10 und könnte mich evtl. am Sonntag mitnehmen?	neutral
Beim Baseball.	neutral
wääääh~ blöde urm... keinen bock mehr zu lernen T__T	negative
Cappu und Keks — at Oldenburg ~http 	neutral
Die Tage werd ich mal wieder meine Haare färben :P	neutral
Schnellzauber-Sets [W1] - ~http 	neutral
Die @user - Das unbekannte Wesen ~http	neutral
Kandidat Peter Müller stellt sich vor. ~http	neutral
Hier könnt ihr sparen ohne ende ;einfach mal rein schauen ~http 	neutral
"Ich mache grundsätzlich hinter meine Tweets ein ""!""; damit ihr sie auch lest!"	neutral
Mobbing &amp; Andreas Höhne; Berlin-Reinickendorf ~http 	neutral
Gewinne ein Jahresabo des Kiteboarding Magazin ~http 	neutral
Jetzt gerade auf VOX - Spiegel TV: Nachhilfe beim Therapeuten; wenn das Haustier Probleme hat - Sendung verpasst? Schau: ~http 	neutral
Nachrichten Krefeld Krefeld - Königstraße: Stadt rudert zurück ~http 	neutral
Dieses Video weitergeben -- NIKE ADVERTISINTG ~http  via @user	neutral
Komme zu „Monkey Disko vs. Wicked & Wild  mit GANJAMAN live“ Freitag; 9. September von 22:00 bis 05:00 .... ~http 	neutral
bin kurz ca 1h weg...bd le: *	neutral
News Paper Wars für die PSP angekündigt ~http 	neutral
Neue Arbeit für Samsung Österreich:  ~http  ~http 	neutral
Deutscher Meister Kickboxen. Alexander Yoon ist Deutscher Meister in Dessau geworden! ~http 	neutral
Ich hasse dich Ich hasse dich  Ich hasse dich Abgrundtief  Ich hasse dich  Ich hasse dich  Ich hasse dich weil du mich nicht liebst #raheem	negative
Schön; wenn im Bad das Wasser zur Abwechslung mal nicht aus dem duschkopf kommt sondern von der Decke tropft! :( #Wasserschaden	negative
Umwelt: Kolumbien will Holzeinschlag im Regenwald bis 2020 komplett einstellen und bis dahin 77% der Energi… (cont) ~http 	neutral
#mitdemradzurarbeit Ich fahre immer mit dem Rad	neutral
Wunderkind stellt in NY aus ~http 	neutral
Es ist soweit: es warten 10 MNY Sets auf Euch uuuund eine Nintendo Wii. Im 24. Türchen unseres Xmas Kalenders ~http	neutral
Besuche die originalen Filmschauplätze in #Ludwigshafen und begib dich auf deine eigene Spurensuche am #Tatort. ~http	neutral
Pommern im Siebenjährigen Krieg: Wissenschaftskonferenz und Ausstellungen am 20.05 in Kolberg. Weitere Infos unter: ~http 	neutral
Kluge Köpfe kochen gesund: Das 1 x 1 der ausgewogenen Ernährung - von Alice M. Stockreiter et al. ~http 	neutral
hat jemand ne Ahnung was so sehenswertes im TV läuft heute abend?	neutral
"Techniknews: ""Office 365"" - Microsoft Office Webapp im Browser - Beta startet heute; Anmeldung kostenlos ~http  @user"	neutral
Da habe ich die @user wohl so energisch angeklickt; dass 'sie' mir gleich wieder davongesprungen ist ... Soeben sicher eingefangen.	neutral
Evolution: 13 Mrd. J.; Big Bang: Wasserstoff. 4;5 Mrd. J. biologische E.: Menschen ((C) by H. v. Ditfurth) ~http 	neutral
Irgendwie verstehe ich bei der Activia Werbung immer; dass die Frau zwei Eisbären gegessen hätte.	neutral
Achtung; jetzt kommt ein; nein kein Karton; sondern ein Test; beep; beep... #fb	neutral
Karneval 2011: Cowboy oder Indianer?	neutral
Heute ist eindeutig einer dieser Tag wo man bereut jemals aufgestanden zu sein!	negative
! Samsung Handy; SGH - T659 in Krefeld: Funktioniert einwandfrei. Mit ladekabel und gebrauchsa... ~http  ~http 	neutral
Essen ohne Stress: Wie Ihr Kind mit Spaßund ganz von selbst richtig essen lernt	neutral
Lieber @user. Sagst du mir deine MC Server IP?	neutral
Hat Anonymous jetzt heise.de runtergefahren; oder was?	neutral
Halsschmerzen / Kopfschmerzen ;( Nachher Zeitungen verteilen -.- Ob ich das überstehe ? :D	negative
.@weltonline: Aus für „Literarisches Quartett“ ~http 	neutral
Premium Kleinanzeige: Microsoft Office 2010 Academic.... ~http 	neutral
"BGH zur Zustellung ""demnächst"" ~http  #fristwahrung"	neutral
New Post:  Samsung Chromebook ab morgen verfügbar ~http 	neutral
Der erste Stock; die Haupthalle.  ~http	neutral
Grüne beenden Koalition mit der CDU in Hamburg ~http 	neutral
Weltweite Wii-Software-Verkaufszahlen von Nintendo: Nintendo hat eine Liste mit weltweiten Software-Verkaufszahl... ~http 	neutral
ich finds teils recht lachhaft; wenn deutsche meinen englische Übersetzungen von japanischen Texten zu übersetzen :D	negative
Neuen Podcast aufgenommen...Stimmung trotzdem auf dem Nullpunkt.	negative
Du kannst mir bestimmt sagen; wo ich in #Nagold länger als 3 Stunden #kostenlos #parken kann. #strafzettel #abzocker	neutral
New Post:  Samsung Galaxy Tab 7 aufgetaucht ~http	neutral
Wäsche bügeln	neutral
Ob hier heute noch Sport vermarktet wird? ZWEIFELHAFT. #schaufelstillstand	neutral
Brustkrebs Reha Bayern? ~http 	neutral
So; wir bauen grade kräftig am Programm für die nächsten Monate. Nächsten Freitag starten wir aber erstmal so richtig für 2011.Bloomclub yo!	neutral
PDS ® Performance Development System; 1 ganzheitlich-systemisches Entwicklungs-Konzept für Menschen (Leben) versus Kybernetik für Maschinen!	neutral
wer im schlamm steckt;kann über ein schiebedach froh sein. #searock	neutral
Kleinanzeigen: Nur noch 13 Nintendo DS DSi Lite 3DS Spiele in Magdeburg: High School Musical ... ~http  Magdeburg Anzeigen	neutral
You can touch this! Wie die Microsoft Touch Mouse entstand:  ~http 	neutral
Wir sind auf der sony ericsson schulung angekommen. Mal sehn was es neues gibt.	neutral
Angesichts des Absatzbooms in Asien und Südamerika wollen BMW und Audi ihre Aktivitäten in den Schwellenländern ausweiten... (Reuters)	neutral
"Microsoft veröffentlicht den ""Building Windows 8"" Blog: Bisher hat sich Microsoft sehr bedeckt gehalten; was ihr... ~http "	neutral
gleich zum Nebenjob!!	neutral
Oft werde ich gefragt; mit welchem Programm ich meine Fotos bearbeite. Mit #FixFoto arbeite ich schon mehrer Jahre ~http	neutral
Haben gerade Kai Pflaume auf dem Microsoft Stand interviewt! #CeBIT #CeBIT10 ~http 	neutral
So endlich Feierabend :) Werd mir jetz erstmal ne coole Hose kaufen gehen dann nach Hause bissel weiter schrauben :)	positive
Neue Finanzregelung wird die Vereine verändern ~http	neutral
Wuhu mein Sony Ericsson Satio wurde schon auf 50 € geboten! So kanns weiter gehen xD	positive
MAN ist nun mit einem eigenen Kanal auf dem führenden Internet-Videoportal YouTube vertreten. ~http 	neutral
Ich habe ein neues Foto auf Facebook gepostet ~http 	neutral
"Beliebte Produkte im Chemnitzer ""German's"" Bistro sind Croissants und Donuts."	neutral
Und ja. Ich hatte vorher einen quadratischen Monitor :D	neutral
An Anika: Ich liebe das Kochbuch!! Ich muss unbedingt was daraus kochen! Danke für deinen Brief und den Geburtstagsgruß.	positive
hat morgen ihren letzten offiziellen Schultag; eeehe eeh :-)	positive
Das heute Abend war toll ♡	positive
HAHA RT @user Scheiss Rockermähne-Sie musst beim kotzen meine Haare halten!	negative
Netzgeflüster:  Das war's - HAZ ~http 	neutral
Corporate Wording mit Text-Bausteinen verleiht Business-Profil sowie Zeit- + Geld-Ersparnis für alle Kompetenz-Bereiche und jedes Business.	neutral
Wichtig für alle die ein #ff geben - hier die Regeln in Deutsch: ~http  BITTE RT!	neutral
NEWS von der Weltreise: Quiz: Auflösung und Gewinner ~http 	neutral
#Bahrain #Libyen #Interview zur #Lage in #Japan und deren Ausmaß! ~http  #berlin	neutral
ja 6 siege aus 10 spielen super !! #duknb	positive
"neuer follower ""Lernen mit Lerninstrumenten; Team-; Verkaufs-; Persönlichkeits- und Werteentwicklung; Talentmanagement"" wird mein schüler"	neutral
Basic Thinking verschenkt das Samsung S7070. Ich will mit in die Lostrommel: ~http  #Divatelefon	neutral
Corporate Wording mit Text-Bausteinen verleiht Business-Profil sowie Zeit- + Geld-Ersparnis für alle Kompetenz-Bereiche und jedes Business.	neutral
Von höchster Stelle: Hallöle! Wie die Gerüchteküche erzählt; soll der oberste Chef im Landkreis; Thomas Bold; sich... ~http	neutral
Agile Projekte und Scrum in der Praxis: Elemente; Nutzen; Tools; Hürden ~http	neutral
man ist das schön DSDS gucken; surfen und Alk^^	positive
Flugspecial Asien; günstiger Thailandurlaub am Golf von Siam; Thailand Special von Etihad Airways... ~http 	neutral
Die Foto Konijnenberg Wochenaktion: Das Samsung WB650 Urlaub-Set diese Woche für nur € 199;00: ~http 	neutral
Endlich ein anständiges Piericng für die Zunge gekauft; ich kann wieder reden!	positive
Mein Daumen faengt an zu kratzen Dc	negative
Französische Revolution von 1789 - ein kurzer Überblick ~http 	neutral
Auch ich muss mal wieder arbeiten gehen :D	neutral
Und manchmal nervt es; dass NewYorker keinen Onlineshop hat. D:	negative
...morgen warsch. eLp mit den besten Mädis :) ...ennnnnndliich wochenende....guck mir jz GZSZ an :)	positive
MORGEN !!! SAMSTAG !!! LUST N LOVE !!!! LIVE !!! ROADRUNNER'S ROCK & MOTOR CLUB !!! U-Bhf Senefelder PLatz !!! AB 11 g… ~http 	neutral
in letzter zeit will ich nur noch schlafen	neutral
Wer fordert jetzt ein Fernsehverbot von G. #Depardieu?	neutral
Jemand interesse an ein Sony Ericsson Satio? 1 Jahr noch Garantie.. Melden ;&gt;	neutral
Heute Essen war supii :**  hBa dich lieb	positive
Wünsch dir was  ~http 	neutral
Komme zu „Festliche Konzert Gala 2010: DON KOSAKEN CHOR SERGE JAROFF“ Sonntag; 7. November von 16:00 bis 18:30 .... ~http	neutral
Ist es nicht süß? :P ~http 	positive
Aktion Jackson was los wo bleiben die Lappen die du schicken wolltest?@Sinnhat21	neutral
Dieses Video musst du dir ansehen! -- glenn frey - the heat is on video ~http  via @user muß sein ^^	positive
So; jetzt erstmal anziehen & arbeiten gehn ... xD	neutral
Markt: Suche Reitbeteiligung in Dresden - Kleinzschachwitz ... ~http	neutral
gibt gleich Nachhilfe .. 2 Stunden lang :/ naja egal  ;D .. Morgen Montag ..oooooh kein Bock alter. Nur noch 12 Tage dann endlich 15 :D	na
... erinnern wir uns: Deutsche Steuerhinterzieher verursachen 10 mal höhere Schäden als der gesamte deutsche Sozialetat beträgt!!!	neutral
#nowplaying wir sind helden - die ballade von wolfgang und brigitte	neutral
Website zum 25-jährigen Zelda-Jubiläum geht online: Nintendo hat heute die japanische Website zum 25-jährigen Ju... ~http 	neutral
Mit Pfeil im Gesicht??	neutral
Plant ein Wochenende in Hamburg. Tolle Stadt; tolle Leute!	positive
Modebewusst; Links; BMW.@~http  #Hohmann-Dennhardt: Eine rote Dame für #Daimler (von Lisa Nienhaus) ~http	neutral
Unser Angebot für Latinisten und andere Philologen: ~http  #latein #mittelalter #ausonius #philologie #verlag #kliomedia	neutral
Er fliegt immer an der Wand lang und macht 'pfffffffffff' oder so.	neutral
Nachholbedarf beim E-Antrieb: Audi forscht in China - News - FOCUS Online ~http	neutral
Und am Ende der Straße steht ein Haus am See.	neutral
Dana International? Kommt wohl grad in den Stimmbruch... #esc	neutral
man scheis schule! könn mich alle ma! scheis lehrer! sollen sich doch alle figen!	negative
"KOLOBRZEG.DE bzw. KOLBERG-URLAUB.DE verbessert das PageRank auf ""4"" und zieht damit mit dem offiziellen Portal der Stadt gleich!"	neutral
Ich bin morgen bei #twremen die mit 'nem älteren werdertrikot von boenisch (2) :)	neutral
Hier sehen wir den weltberühmten Schriftsteller im Begriff; sein jüngstes Manuskript einzuwerfen... (Snoopy) :D	neutral
"Heise-Forum zum iPhone: ""und wenn du eine Tastatur hast - dann hast du auch kein iPhone.."" ""ein Smartphone sie zu knechten..."""	neutral
coco bar mit Maria; Ahmed; Riyat und Bertan :D	neutral
Photo´s online bestellen; einfach auf sn......sh herunterladen und sogar bearbeiten; easy	neutral
der aktuelle Sportplan ~http 	neutral
MAD Plastic Fantastic! Neben unseren extrem populären; sehr fängigen Imitationsködern aus Plastik bieten wir jetzt... ~http 	neutral
Die Erfahrung ist wie eine Laterne im Rücken; sie beleuchtet stets nur das Stück Weg; das wir bereits hinter uns haben. Konfuzius	neutral
#Petition Anlegerschutz: Unterstütze die Forderungen nach strikter Kontrolle der Banker ~http  #toobigtofail #finanzkrise	neutral
wie süß *-*	positive
Twitter-Gewinnspiel von SE: @user folgen; #WinSatio posten und ein Sony Ericsson Satio gewinnen	neutral
Verdammt; war der Film cool! #fastfive	positive
#ISP #Domains : Preiserhöhung für #TLD .tc ( #Turks- & Caicosinseln ) um 1;50 € - NEU 22;50 € für 1 Jahr - ~http 	neutral
Schaue jeden Tag bei @user vorbei!	neutral
2nd Level im Microsoft Umfeld zu besetzen: näheres hier ~http  oder direkter Kontakt	neutral
Nich daa - ma eben weech.	neutral
Ich hab das mal ausgerechnet. Komme auf 6743 Jahre Beziehungspech durch Unterbrechungen von Kettenbriefen.	neutral
Hergeschaut! Nintendo auf der GDC ~http 	neutral
Eine phantastische Sängerin ist Toni Childs. ~http 	positive
Ändere Deine Worte; dann ändert sich Deine Welt!    ►► VİDEO  ~http 	neutral
Der @user verträgt glaub ich nur den Fusel aus dem tetrapack am besten vom günni	neutral
Kleinanzeigen: Sony Ericsson Xperia X10 mini Pearl/White Pink in Magdeburg: Ich verkaufe mein... ~http  Magdeburg Anzeigen	neutral
ich will meine Kamera jetzt. sofort. meeeeh ._. und ich Doofkind hab auch noch meinen Stick mit den Fotos in der Akademie vergessen &gt;_&gt;	negative
Der gestrige Abend war.. kaputt.	negative
Fuck. Ich bin krank. Letzte Nacht gebrochen und heute total im Arsch.	negative
Handy-Markt: Samsung und Apple stoßen Nokia vom Thron ~http  via @user	neutral
Schweinefleisch-Produzenten wollen Probleme selbst lösen ~http  via @user	neutral
Endet heute: Hilton - Sparen Sie 35% bei Ihrer Buchung von mindestens 2 Nächten im Hilton Antwerp mit diesem Hil... ~http	neutral
"Ganz frisch: ""Plan B"" von unserem Debütalbum ""KonTakt"" - sexy compiliert: ~http "	neutral
Testankündigung - Xtreme cellulite Creme... ~http 	neutral
Nicht Gesund; aber Mitten im Leben: Foto des Monats: September 2010 ~http 	neutral
und dann kommt der Tag an dem die ganze Welt unter dir zerreist...	negative
Coripa Maßkondome - Heute letzter Verkaufstag - nur noch bis Mitternacht bei uns erhältlich: ~http  Jetzt noch zugreifen!	neutral
Wechsel von XING zu LINKEDIN...ist es von Vorteil oder wieder nur ein Zeitfresser? ~http  Mein Tipp: Zu LINKEDIN WECHSELN	neutral
Update für Deutsche Samsung Galaxy S2 mit dem DBT Product-Code via KIES	neutral
Ausführliches Qype-Profile-Update erfolgt: ~http	neutral
die jugend heutzutage..	negative
"Definiere ""Erzählstruktur""! #verwirrterGeldgeiler #Domian"	neutral
Mit einem Retweet an der Verlosung von 15 Nintendo DS teilnehmen =&gt; ~http  für Affiliates + Retweets	neutral
"Kolumbien & Gesundheitstourismus: Vom 18. - 19.05 wird auf dem 1er ""Encuentro Internacional de Oportunidade… (cont) ~http "	neutral
Sitze in der Schule und teste mein Google Twitter Gadget	neutral
Wie findest du die werbung von katy perry auf prosieben?	neutral
Unglaublich; dass es immer noch Blogs ohne RSS-Feed gibt...	negative
#einkaufen #sparen #1: Samsung EB-K1A2BEBEGSTD Akku mit Gehäuserückseite für Galaxy S II: Samsung EB-K1A2BEBEGST... ~http 	neutral
"Nächstes mal werde ich Microsoft Sam ""Nooo"" sagen lassen und daraufhin dem Patienten sagen: ""Computer sagt nein..."""	neutral
Angebotswochen für Tattooentfernung haben begonnen...	neutral
Unsere Marke: PDS ® Performance Development System; ein ganzheitlich-systemisches Entwicklungs-Konzept für Personen + Unternehmens + Org.!	neutral
Weihnachtsmarkt war geilo. Jetzt nach hause und dann überlegen was als nächstes anliegt :)	positive
Ja geil Noiceroom is dick! Lass ma abgehen!!!	positive
HEUTE 02.07.10 Jam Session |Start 21:00 Uhr| Eintritt 2€ (Vereinsmitglieder frei) ~http	neutral
Für alle; die wissen möchten wir man ein Gespräch ganz einfach in Richtung XYZ lenkt:... ~http 	neutral
Tagesstatistik: 308 neue Beiträge; 16 neue Themen; 12 neue Galeriebilder! Verpasst? ~http 	neutral
Rheinterassen mit Helena - Sonnenanbeten Folge 2	neutral
Rommel und kein Friede: Darf man einen von Hitlers wichtigsten Kriegern; nämlich den Generalfeldmarschall Erwin ... ~http 	neutral
Die kolumbianische Künstlerin Raquel Hofer beteiligt sich am Freiluftsymposium vom 30.08.-3.09. in Neuenrade ~http 	neutral
Wohnen - Ideen & Inspiration: Am Wochenende macht man es sich doch am liebsten gemütlich; oder? Zumindest am Son... ~http 	neutral
Drucker-Sonderpreise: z.B.: Samsung ML1860 um 35;- Euro; Canon MX360 um 49;- Euro; Canon LBP5050N um 135;- Euro exkl. MwSt. Unglaublich!	neutral
Ich mache keinen #ff weil ich faul bin oder so; ich vergesse nur immer wann grade Freitag ist :'D #nurzurinfo	neutral
#MNvienna FHWien grüßt Dejan Palalic und freut sich auf den MobileMonday #momoat //mg	neutral
freundin is da :D	positive
Wir haben zwei neue Outdorseite in unserer Blogroll: Freiluft-blog (~http  und Trekking | Blog (~http )	neutral
Ach ich liebe mein Samsung Galaxy S mit Android ..und Danke Appel du hast gezeigt wie ein Smartphones sein muss	positive
iPhone Apps Update: Erde und Weltall - Die neuen Irrtümer der Allgemeinbildung | Leseprobe (books): .. ~http  ~http 	neutral
Soziale Netzwerke wie #Facebook oder #Xing werden bei der Polizei bei der #Fahndung nach Verkehrsündern immer beliebter. ~http 	neutral
Dieses Video musst du dir ansehen! -- Hate2Lose- Skaten und Konzert Kassel ~http 	neutral
Machst du dann dieses Zeitraffer mit Power Director oder mit Sony Vegas weil mit(@YouTube ~http )	neutral
Ist mal wieder auf dem Weg nach Mannheim. Schön. Und wieder ein mal ist die Klimaanlage ausgefallen. Nicht schön.	na
Ja das wars :) aber jeder tag mit dir ist toll &lt;3	positive
wasfür ein fetter sound: get well soon - und legal kostenlose live ep ~http 	positive
oh schon fast vier :/ warum bin ich denn noch wach??	neutral
Geld sparen und verdienen ~http 	neutral
Die Sparkassenkunden im Freistaat geben wieder Geld aus − vor allem für Häuser und Grundstücke. ~http  #Kredite #News	neutral
Kostenlos inserieren im Anzeigenverteiler anzeigenschleuder ~http	neutral
Fußball & seine Rolle im südafrikanischen Nation Building - Prozess ~http  ~http	neutral
"Haben uns im Festival Walk ""True Grit"" angeschaut. Klasse Film -- und mit sehr nettem Humor..."	positive
"F.A.Z.-Blogs ""Mühsam richtet sich die Generation 40plus im digitalen Leben ein"" ...~http "	neutral
Und schon kommt einem das Leben ein kleines bisschen grauer vor...	negative
Zuckerrübenernte auf Rekordniveau! Wenn deine Lokalzeitung damit eröffnet ist es an der Zeit in eine Großstadt zu ziehen.	negative
Neu - erkunden Sie die Vulkaneifel mit unseren Pedelecs! Ein eingebauter 250KW Elektromotor unterstützt Sie... ~http 	neutral
Verfügbar	neutral
Ich hab endlich nen Kleid für die Silberhochzeit meiner Ellies!!	positive
Neubau von eleganten Eigentumswohnungen mit Fahrstuhl - Top Innenstadtlage - Wohnung; 26135 Oldenburg Kaufpreis: 167… ~http	neutral
Doppelganger Week: @user besitzt meiner Meinung nach leichte Ähnlichkeit mit ... ~http  ?! ;-)	neutral
beim chatten erhält man häufig schnellere Antworten als bei twitter --&gt; chatten gespräch verläuft schneller	neutral
#ISP #Domains : Preiserhöhung für #TLD .com.ph ( #Philippinen ) um 1;00 € - NEU 100;00 € für 2 Jahre - ~http 	neutral
Heute werd ich gefirmt :D	positive
Neue Nike 6.0 Shoes eingetroffen! U. a. ~http 	neutral
Das Foto Konijnenberg Kenner-Angebot: Das Sony SLT-A55 Starter Set aktuell für nur € 739;00: ~http	neutral
"ich les gerade; dass eig. johnny depp und noch so eine andere das paar bei ""titanic"" sein sollten; sie es jedoch ablehnten ;D"	neutral
Folge dem kopf; oder so.	neutral
anthropogen - vom Menschen gemacht - man lernet nie aus	neutral
ARD-Buffet-Wandertag / Die Vorbereitungen für Sonntag sind in den letzten Zügen.Die letzten Infos für alle Teilnehmer: ~http 	neutral
Keine Halterhaftung bei Parkgebühren: ~http	neutral
Spieglein Spieglein an der Wand; welcher ist der beste Tweet im Land?	neutral
Suche eine Tasche für mein Acer Iconia Tab A500 und diesen neuen Akku für das Samsung Galaxy S2?	neutral
die Dokomi war so toll &lt;3 Hoffentlich kann ich die Mädels alle bald wiedersehen (vl. nach meinen Umzug oder so)	positive
Man nehme 1 Kilo Nudeln multipliziere es mit 2 Litern Cola und man erhalte mein Abendessen.	neutral
kein Twitter im Reich der Mitte ~http 	neutral
"Veranstaltung Köln: ""Caipirinha Latina"" - Samstag 03. Sept. im Petit Prince ~http  von Salsa bis Reggaeton"	neutral
Trend Drinks: Mit Fotos von Oliver Schwarzwald - von Arnd Heißen - Edition Styria. ~http 	neutral
meine fam ist auch in munchen	neutral
Weil es nicht gestellt ist. ~http 	neutral
Diät gefällig? ~http 	neutral
Wir wünschen allen Kunden und Freunden unseres Weinguts ein gesundes und erfolgreiches neues Jahr!	positive
haha megan fox folgt mir	neutral
GC: The Last Story und Pandora´s Tower kommen nach Europa: Ebenfalls von Nintendo jetzt offiziell und endgültig ... ~http 	neutral
Die Vor und Nachteile von Social Media Marketing &gt; Facebook; Twitter  ~http 	neutral
Ich habe ein neues Foto auf Facebook gepostet ~http 	neutral
Etwas bessere Laune: Heut Mittag gibt es Kaiserbraten mit Sauerkraut :)	positive
Gulp says: MS Security Essentials RTM - kostenloser AntiVirus von Microsoft - Jetzt herunterladen - ~http 	neutral
Eignung der Windkraftnutzung / Windkarte D: ~http  // Positionspapier Windenergie e.V.: ~http 	neutral
Also E-Technik war glaub ich in Ordnung. Physik war mehr oder weniger schlecht. :( so ein Mist. Muss es wahrscheinlich nochmals schreiben :(	negative
Kampf um Bahnhof: Kretschmann rückt von Stuttgart-21-Gegnern ab - SPIEGEL ONLINE - ~http	neutral
Ich verkaufe auch meinen Sony Heimkino Dolby Pro Logic Receiver mit 2 Boxen. Momentaner Stand: 10;01€ läuft heute ab ~http 	neutral
Leider noch ein paar Tage nur Mobiles Internet… werde mich aber nächsten Freitag bei allen #FF´s revanchieren :-) DANKE!!	na
Da kommt man gestresst nach Hause und das Bett ist abgebrannt... Es gibt diese Tage da sollte man einfach zu Hause bleiben...	negative
Wenn es eines ist; was ich nicht ausstehen kann; dann sind das Lügen.	negative
Wer auf dem Holzweg ist; sollte Leim dabei haben.	neutral
aber nachher ab 14 Uhr  gibts dann Frühstück und Mittagsschlaf. freu :-)	positive
Neue Einträge im Gästebuch ~http 	neutral
Video schneiden. ;D	positive
#1: Samsung EB-K1A2BEBEGSTD Akku mit Gehäuserückseite für Galaxy S II: Samsung EB-K1A2BEBEGSTD Akku... ~http  #handy	neutral
Ich habe den Kanal von CuteBlondieYulie auf YouTube abonniert (~http ).	neutral
reife-freche hat einen Chat er&ouml;ffnet. ~http  ~http 	neutral
Levin+Westermann+-+Schimmelpilz+als+Zwiebelmuster ~http	neutral
Kopfschmerzen X___x - Der heutige Arbeitstags war echt anstrengend. Heut geht's früh ins Bett...	negative
Ich hasse es; wenn ich bei Passwörtern so kreativ war; dass sie mir selber nicht mehr einfallen...	negative
Bing: Für 2;5 Milliarden Dollar Umsatz hat Microsoft 5 Milliarden Dollar ausgegeben. ~http  #bing #ms	neutral
Klar; 20°C; Wind: 4 km/h SSW (20:00) #Luzern	neutral
"Ein richtiger Ohrwurm :-) RT @user ""Keks!!! Alter Keks! ist der mit Ohrsand?"" (@helge kommt auch vor) ~http "	positive
#WHS News: Hat der Windows Home Server überhaupt noch eine Zukunft?: Wer sich mit dem Windo... ~http  @user #NAS	neutral
WARM! O_O Ich weiß nicht wieso; aber ich fühl mich Heute sexy!!! 8D	positive
Frauen- #WM Meine Güte ist #Marta cool vor dem Tor. Die hat die Ruhe weg. 3:0	positive
Mein neuer Shop; ich freue mich auf Ihren Besuch ~http 	positive
Guten Morgen Leute..gerade aufgestanden und jetzt die pizza in den Ofen schieben^^	positive
Alle reden von Bing. Mir fällt da erstmal vorrangig Chandler Bing aus #Friends ein... falls sich jemand daran erinnert... #Bing	neutral
#Reisen heißt; die menschliche Existenz ins Schaukeln zu versetzen; sie andere Formen des Daseins probieren zu lassen. (Michel de Montaigne)	neutral
lieber heute ein Samsung Galaxy S2 als irgenwann ein iPhone 5	neutral
So; die letzten beiden kleinen süßen Schlingel haben nun auch ein gutes neues Heim gefunden! Danke an alle; die eins adoptiert haben!!! :-)	positive
hmmm. immer noch krank  =/  Was ein geiler Schultag haha =D hab ein 3- in Mathe wuuuh  =p	na
#WM 2010: Nike; Adidas & Co verlagern ihre Werbekampagnen ins Internet - ~http  #Marketing #PR #SocialMedia #Werbung	neutral
Hack n Slash Cup #4: Nach Sieg gegen NaN ist DkH.HoN im Halbfinale gegen Fnatic ~http 	neutral
NEU: 3DS ab Wintersaison für 170€; schon früher gekauft? Dann Schenkt dir Nintendo 20 Spiele in eShop (mehr info ~http )	neutral
Rebsorten ABC - von Dagmar Ehrlich - Gräfe & Unzer. ~http	neutral
"Konzert: Am 03.06. in Frankfurt Salsa-Konzert mit ""Doble Jugada"" (aus Kolumbien / Kuba) im ""Latin-Palace Chango"" ~http "	neutral
Ich nehme an der Samsung Galaxy S-Verlosung von @user und @user teil: ~http 	neutral
Komme zu „Bottich“ Freitag; 1. April 2011 von 20:00 bis 23:30 . + Dumbell ~http 	neutral
Microsoft arbeitet an Bing und Windows Live Messenger ~http 	neutral
Durch einen Tunnel; der die Residenz des Staatschefs mit der des frz. Botschafters in der Elfenbeinküste verbindet wurde Gbagbo angegriffen.	neutral
#1: 5 x mumbi Displayschutzfolie Samsung i9100 Galaxy S II Displayschutz CrystalClear unsichtbar Fo... ~http  #handy	neutral
#Meral ist geil Elektrisches Gefühl #Juli #XFactor	positive
i ha scho en wiehnachtsgschenkli becho... ziel: schoggi-santa uffresse *freu*	positive
Endlich mal wieder SONNE! - Setzt die Sonnenbrille auf; Leute! 8)	positive
Huch; schon 12 Uhr. Wann ist denn bei euch Mittagspause?	neutral
#Wohnen und #Einrichten in #Berlin ~http 	neutral
Kampf um den Leser: Yahoo; Google und Bing spannen zusammen ~http 	neutral
nacher nt fetzen und dann zurück gammeln	neutral
Immer schön klicken! Seid ihr auch bei Dschini? Klicke gerne zurück. ~http 	neutral
Hergeschaut! Nintendo 3DS – 3D ohne Brille ~http 	neutral
Ein Mann hat sich Viagra verschreiben lassen und der Arzt hat ihm empfohlen; eine Stunde vor dem Verkehr die P...~http	neutral
Talentloser Musiker? Bei @user aus gesummter Melodie 'nen ganzen Song machen. Vorhin bei Funkhaus Europa und jetzt auf ~http 	neutral
Ich habe 3 Fotos im Album „25. Mai 2011“ auf Facebook gepostet ~http	neutral
Rezept: Haferflocken Frühstück ~http	neutral
Ich habe gerade einen Lauf über 9;02 km in einer Zeit von 49:08 mit Nike+ GPS beendet. #nikeplus	neutral
Tec Watch; Neues von der #IFA ~http	neutral
Okay; merke wenige Minuten später bei der Deutschen Bahn heißt 7min.	neutral
Dank des großen Erfolgs des Deutsche Telekom ITV Award 08 startet Microsoft eigenen Contest (Zitat Microsoft Mediaroom User Group Summit)	neutral
Irgendwie is alles doof...	negative
Gut gestärkt vom Mittagessen starten wir nun mit den Anträgen #kjgdk	positive
Gute #Körperhaltung pusht die #Ausstrahlung. Der beste Trick: SBD.	neutral
Heute offizielles 2.3.3 Update für das Samsung Galaxy i9000 und Galaxy Tab	neutral
Der Tod Gottes ist eine interessante Meinung; aber sie berührt Gott nicht. (Nicolás Gómez Dávila)	neutral
Nortel-Patente gehen an Gruppe um Microsoft und Apple - Google zieht den Kürzeren ~http 	neutral
Villa de Leyva im Departament Boyacá: 438 Jahre Geschichte und Kulturerbe Kolumbiens. @user Fotos ~http 	neutral
Man man man wie ich diese Typen von xBox hasse!! die mit ihren xbox kinect so eine billige und dreckige sache; sony hat ja was viel besseres	negative
"Neues Microsoft Office Zeitalter.Auch Windows soll in Zukunft nicht mehr auf dem Rechner sein sondern in der ""Cloud"" zur Verfügung stehen."	neutral
geil; wenn man bis 2 uhr nachts in der schule hockt und alkoholische getränke ausschenkt ... so sollte das immer sein	positive
Der #Ständerat hat gegen die Interessen der Reisenden entschieden ~http  #Bahnreform #SBB #ÖV	neutral
Chuck & Larry auf Sky. Der Film ist einfach gut!	positive
Urlaub fängt mit der Erkenntnis an; dass mir jemand ne fette Beule in die Tür gefahren hat und abgehauen ist :-(	negative
Der ist j sooo süß der kleine. :) /⁰Heute kommt mei Schatzi wieder heim. :-* /⁰Dann Tischtennis gegen Döhlau.	positive
Einfach nur unglaublich gut! *___* (watching Neues vom Wixxer) ~http 	positive
Ich wuensche allen schoene Weihnachten. I wish a happy chrismas.	positive
Das moderne Home Shopping Business. Clever shoppen von zuhause aus; mit einer gigantischen Auswahl. ~http 	neutral
noch 4x Schlafen...~http 	neutral
Coffee Circle: Online weltbeste Kaffees kaufen und Entwicklungsprojekte unterstützen: ~http 	neutral
Matrix ist so ein NERD-Film	negative
Der Winter naht mit großen Schritten… ~http  #briard	neutral
spielt heut nich schland gegen afghanistan - fast! #ger #aserbaidschan	neutral
Verwende nun Twitter zusammen mit StartXXL: ~http 	neutral
Ich möchte einen Preis beim Geburtstagsgewinnspiel von @user gewinnen: ~http  #Caschy	neutral
Das war rot du spasst.	negative
Android-Superheld im Samsung Galaxy S II ROM entdeckt ~http  via @user	neutral
=) danke schön!	positive
Yeah! bin alleine in nem fremden Haus.	positive
Schnee Schnee Schnee ~http	neutral
Die Klangkammer gibt es jetzt auch im tiefen weiten Internet. Nicht nur in der gemütlichen blauen Zone. ~http 	neutral
Ich stepe mit meinen neuen Nike Blazer Vintage. Durch die Gegend. #swag	neutral
früher waren lehrer immer diese menschen ohne privatleben. jetzt; wo ich lehrer kenne & teil ihrer privatleben bin weiß ich es: ICH BIN ALT!	negative
ich sollte mal mit dem fressen aufhören.. echt grausig. was nur los? D:	negative
Sie haben noch keinen Tablet-PC? Dann sollten Sie jetzt am großen- Gewinnspiel teilnehmen! ~http 	neutral
so ab jetzt ~http  ~http 	neutral
Weitere Details zum Wii-Redesign in Europa: Wie das Official Nintendo Magazine aus Großbritannien berichtet; wir... ~http 	neutral
Hoffentlich gucken viele #WM; dann wird das später ein entspanntes shopping in #wiesbaden	positive
Ein frohes neues Jahr 2011!	positive
Quacksalber leitet kein Fachkrankenhaus mehr ~http	neutral
BGH erklärt Lehrerbewertung bei Spickmich.de für zulässig ~http 	neutral
In der Haribo Colo-Rado Tüte sind auch immer weniger Sachen drin; die ich mag...	negative
"Stellte grad Wortsuchfunktion ein und tippte ""Ficken"". Ganzer Bildschirm wurd gelb. Was soll mir das jetzt sagen?"	neutral
Aufrecht: 2011 ist das Europäische Jahr der Freiwilligentätigkeit. In Stuttgart wird es dazu am 20. und 21. Sept... ~http 	neutral
"Ich will das Android-Smartphone Samsung Galaxy Ace bei @user gewinnen. ~http 
neutral	3	30101	Ich habe ein YouTube-Video zu meinen Favoriten hinzugefügt. -- S-BAHN- TRAIN by Paul Kalk ~http 
neutral	3	29363	Warum wird neben dem Unilever Gebäude in der Hafencity ein Riesenrad aufgebaut???
negative	3	34308	Bad putzen : (
neutral	3	11660	Eine erstes ASCE Plugin System Vorschau Video wurde erstellt. ~http 
neutral	3	20581	Ich glaube es dauert nicht mehr so lange also weil wir alles neu amchen müsssen und haben jetzt auf page neue uptades gemacht dan bis dan bb
neutral	3	22104	Wir haben das Mammut Smart Alpine für euch getestet. Schaut es euch an: ~http
positive	3	2852	Noch ein Follower ? Dann hätte ich die 500. Wär Obbergeil :)
neutral	3	46670	Sollte Inter Mailand im Dezember auch noch den Weltpokal gewinnen; dann wird das Trikot ganz schön mit Aufnähern voll geklebt sein.
positive	3	46196	Ich bin Online. war gar nicht so einfach die ip zu finden um die Kindersicherung auszuschalten :-) Wie fettttttttt
neutral	3	35679	Konzeptionerblog: Das verflixte 7. Jahr ~http 
neutral	3	14271	duschen ~http
neutral	3	16179	Kann man die Haarfarbe im Nachhinein verändern?
neutral	3	18300	Plagiatsaffäre: Bayreuth appelliert an Guttenberg (von Heike Schmoll; Berlin) ~http
neutral	3	22903	Tipps zum Energiesparen in der aktuellen Kundenzeitung; auch Online lesen! ~http 
positive	3	39134	Ich kann schon wieder den Schreibtischgrund erkennen! :-) Gleich bin ich fertig mit aufräumen.
neutral	3	34302	EU: 42% der Europäer will nicht in den Winterurlaub fahren #Krise ~http  // Dafür bleiben die Pisten leer
neutral	3	9738	Gewinnspiel auf @user - Als Gewinne winken ein Samsung Full-HD LED 3D Fernseher und iPads! #gewinnspiel ~http 
neutral	3	30628	So würde ich es auch schreiben: ~http 
neutral	3	5445	Das Wort der #Grünen in der Bundesrepublik Deutschland hat ab heute ein neues Gewicht. #Kretschmann #Grüne
neutral	3	22530	#CDU Bergisch Gladbach sagt ihr Sommerfest auf #Facebook ab. #FB #Facebookfest
neutral	3	19253	Heute zum 1. Mal seit Versetzen der Fähranleger die Starferry genommen-da entstehen ein paar riesige neue Gebäude in der Kowloon-Skyline
neutral	3	1424	Bitte teilen!! JACK JOHNSON Karten  ~http
neutral	3	32365	trägt eigentlich noch jemand Buffalo Schuhe? ;)
neutral	3	34593	für die kalte jahreszeit der altbekannte ~http  pro vs. adidas Techfit  ~http 
neutral	3	35181	Europa: Einziges Zelda-Konzert in London angekündigt: Auf der vergangenen E3 hat Nintendo angekündigt; in jedem ... ~http 
neutral	3	13940	Magazin-Montag: Helden in der Indie ~http 
negative	3	146272	Mein Kleiner hat das Nintendo DS-Teil meines Großen ins Klo geschmissen. Sowas Bescheuertes.
neutral	3	42204	AddPublic: Vortrag einfach einfach Netzwerken"" - oder die Kunst der guten Beziehung am 07.09.2011 in ... ~http "	neutral
Redmond vs. Walldorf Microsoft sitzt SAP im Nacken via Computerwoche ~http 	neutral
Günstige Indienrundreise Goldenes Dreieck mit Kuwait Airways Flugspecial... ~http 	neutral
Kanzlei-Hoenig-Info: Betrug durch Anwälte zulasten der Justizkasse? ~http 	neutral
Habe mich dazu entschlossen  jetzt Spongebob Kuchen zu backen.	neutral
so... deg ticket verkauft bekommen... was sie aktuell an musik produzieren ist net mein fall &lt;_&lt;;	negative
Neue A:153 Waffe [W1] - ~http	neutral
Produktionsnotizen: Am Wochenende hat Lumoon in vollständiger Besetzung alle Musiken mit Sopranistin Christiane Mikoleit geprobt.	neutral
geht auf Manu*L´s seite und hört euch Sommer 20-10 an.. prod. von Chewo..Hamburg-Braunschweig connection..	neutral
adidas AG: Praktikum im Bereich Retail Controlling Market Central: Die adidas AG bietet ein Praktikum im Bereich... ~http 	neutral
Softwarereparatur Bootreparatur für HTC - Samsung usw. ~http	neutral
Heute Nacht gehen die Gutscheincodes für die Nintendo 3DS Aktion raus. Letzte Chance sich zu registrieren. ~http 	neutral
Unser Wetter in Mengen: ~http  #KondorAviatik #Fliegen #Sonne	neutral
freut sich aufs LaserQuest heut abend!	positive
HP Notebook + 2 Samsung Handys + Tasche + Maus für 0 EUR bei Quickhandy ! - ~http 	neutral
~heute Abend Fußball Brasilien gegen Germany nu mal schauen  ZDF 20:15 :) wers nicht wissen sollte...	neutral
Das Liederprojekt auf facebook: ~http 	neutral
ok...weder noch.	neutral
heute abend party; döngesmühle!!!  mit meiner besten!!!	positive
hach ist das schön wenn die sonne scheint xD	positive
NEU: das Ruger Explorer Starter Kit. Luftgewehr im Komplettset für nur 109;95 Euro! ~http 	neutral
spiegel online schreibt; dass obama eine fliege gefangen hat  ~http  und lässt mich ratlos zurück!	neutral
Oh Gott ich beginne zu verstehen.	neutral
"Gibts Videos der ""Überkleber"" von Rinteln? solange gilt die Unschuldsvermutung ? @ #piraten fans #cdu #spd #gruene ~http "	neutral
GC: Nintendos Software-LineUp für das restliche Jahr: Nintendo hat nun die Release-Liste aller Spiele des aktuel... ~http 	neutral
suche ein Samsung Galaxy S i9000	neutral
Bald geht es wieder los; am 16.April wird im kleinen Harz der Halberstädter Dom eingeweiht.	neutral
Amerikanische Sendung zum Thema Lumixyl System-Pflege ~http 	neutral
....wie schön; keine Banane mehr; gut; dass sich manches mit einer einfachen Kündigung lösen läßt...	positive
Danke für´s folgen @user @user @user @user @user ; Euer ~http 	positive
verdammte Urlaubszeit und schon steigt  die Zahl der Fundtiere; der Ausgesetzten !!!	negative
hubschrauber über meinem haus	neutral
pennen binz :D (es ist 04:40)	neutral
Wer noch keinen eBook-Reader hat: Am 16.12. ab 17.00 Uhr ein Sony PRS-505 als Angebot mit eBook-Gutschein. Infos folgen hier.	neutral
Mein Plattenspieler gab nach 12 jahren grad den Geist auf :( Letzter Song: Etta James - Power Play.. R.I.P.	negative
hahahaha was ein Erlebnis im mandalay :D	positive
MediaCreate Software-Charts vom 21. August 2011: Das japanische Marktforschungs-Unternehmen MediaCreate hat die ... ~http	neutral
Beim Aushandeln von Honoraren geht es nicht darum; wer im Recht ist. ~http	neutral
FREITAG 03/09/2010  - SOMMER SCHLUSS VERKAUF..... ~http 	neutral
Ich habe ein YouTube-Video zu meinen Favoriten hinzugefügt. -- Phil Collins - Dir gehö... ~http	neutral
HEUTE 21.05.2010 Jam Session mit Textil-Festival; Start 21:00 Uhr; Eintritt 2€; see more @ ~http 	neutral
ASP war sehr sehr sehr geil! Within Temptation geniesse ich aus der ferne; Beste Freundin lieber mittendrin. #meraluna	positive
#OBI in #Lehrte geht in Stellung und mischt sich in die Debatte ein. Zeitung lesen.	neutral
Installationen Bochel ab sofort online!  ~http 	neutral
Hallo liebe Nadine Bla; die von Dir abgebildete Blume ist nicht die aus der Aktion mit dem Code: GRATIS-BLUME (ab... ~http 	neutral
Heute: Patchday - Microsoft veröffentlicht 17 Bulletins ~http  via @user + CyanogenMod 7 installieren.	neutral
"Sind Multimillionäre; Playboys und Filmstars glückliche Menschen? Oder sind es die ""Armen"" mit weniger Geld in anderen Erdteilen?"	neutral
Wünsche allen die es lesen möchten einen wunderschönen Abend; bei dem Wetter keine Kunst.	positive
Kann ein GPL-Verstoss geheilt werden?: Über Golem.de wurde ich auf einen Beitrag von Naughton aufmerksam; der in... ~http 	neutral
iich liiebe iihn *-* ._. iist heute übelst kopfgefiickt &gt;.&lt; iich hab Kopfschmerzen wie Sau &gt;.&lt;	na
bah. volvic ist ekelig.	negative
lol das mit dem #Dschungelcamp ist einfach nur belustigend haha xD	positive
Frauenfußball ist soooooooooo schlecht	negative
Sind's denn hier StudiVZler dabei! Dann schaut's doch ei'mal nach die Gruppe Kommissar Hjuler !	neutral
wer hier Angst hat hat schon verloren..~http 	neutral
MiMi; unser neuer Online-Aktionsshop; hat wieder geöffnet. Heute gibt's günstige Tickets für die nächste Premiere! ~http 	neutral
Infografik: Skype – von der Idee bis zur Übernahme durch Microsoft ~http 	neutral
"Veranstaltung: Heute; 07.09. in Köln ""A Lo Latino Special"" im Petit Prince mit DJ Eddy & clm ~http  #Salsa #Merengue"	neutral
Vielleicht sollte ich doch mal Bing eine Chance geben	neutral
so ne #Twitter - #Googleplus schnittstelle fehlt aber noch; oder?	neutral
Neuer Online-Lieferservice Lieferheld sorgt für kräftig Wirbel ~http 	neutral
scheiss Wetterumschwung! gnaaahhhh &€kjsbrfbowfoinwrfverksd	negative
ein Fall für den Soziologen #Klo-Grafitti @user	neutral
Kurzer Draht zum Kunden in der #WeltamSonntag! #SocialMedia	neutral
Na Toll! Jetzt ist mir das ganze noch auf den Kreislauf geschlagen. Damit lieg ich für heute Flach :-(	negative
Nur füttern; nicht streichenl bitte! @user @user @user @user @user Twitterzooten #ff	neutral
‘Occurro!’ kehrt in den App Store zurück; Komplett kostenlos ~http 	neutral
Alter wie ich einfach mal so kein Bock mehr hab.	negative
Bildergalerie: Wir hatten ja schon bemerkt; am Sonntag war hier im Wichtelwald viel los. Einer der freundlichen.. ~http	neutral
2:15 streiten die sich um die Flasche xDD(YouTube ~http )	neutral
Foto von Kai Pflaume bei Microsoft im Digitalen Klassenzimmer. #CeBIT #CeBIT10 ~http  ~http 	neutral
Die Trainingszeiten bis zu den Sommerferien sind nun auf der Homepage aktualisiert. ~http 	neutral
wenn sarah knappik im tv über paris hilton urteilt; stimmt was nicht am sonntagmorgen.	negative
Tagesstatistik: 214 neue Beiträge; 12 neue Themen; 9 neue Galeriebilder! Verpasst? ~http 	neutral
:D RT @user Aufgeflogen! Samsung kopierte das iPad schon im Jahre 2006 ~http 	neutral
VIA @user Weil unser Herz Liebe kennt ♥ sehr schön!	positive
Es gibt da ein supi geiles Forum &gt;_&lt; ~http  der Manga ist auch geil *-* das müsst ihr euch ansehen &gt;_&lt; supi game ^^	positive
Mir gehts immer noch beschissen|heftige Halsschmerzen -.-''	negative
News am Nachmittag - Teilweise voll gesperrt: Otto-Brenner / Stadtwerke / Polizei sucht BetrügerInnen / Country-Cody 3. #bielefeld #kanal21	neutral
Fenster zu es zieht!Nein;Fenster zu es stinkt wieder gewaltig im Hinterhof!Was so ein Imbiss so alles ungestraft darf!Frische Luft bitte!!!	negative
Suche: Samsung Galaxy Tab  Verkaufe: Motorola Defy   Hat jemand was?!	neutral
doofes wetter zum bremsen machen...	negative
Zurück aus München; am WE Umzug Teil III	neutral
gerade vom Strand zurück gekommen	neutral
"Noch Plätze frei! Ferien-Workshop ""Die #Technik des #Linolschnitts"" für Kinder ab 8 Jahren schnell bis 26.8. anmelden! ~http "	neutral
Neue Produkte von Samsung im Kommen! Teil 2 ~http 	neutral
#Erfolg mal anders definiert   ~http 	neutral
Ich habe ein YouTube-Video zu meinen Favoriten hinzugefügt. -- Trailer towing fail ~http 	neutral
Das braucht Ihr aber nicht gleich zu können: ~http  #Bosu #Balance #Performance	neutral
Geschafft! ... Knuddelesel.de auf Jomsocial 2.2.1 geupdatet ... läuft noch nicht alles rund; aber wird ja hoffentlich	positive
Wir sind dabei; Wormser Pfingstmarkt! Wir freuen uns auf interessante Gespräche! Halle 5/512 vom 22. bis 30. Mai 2010 ~http 	positive
braucht dringen neue schuhe; ein kleid; ein haarreif; neues piercing; neue oberteile ...♥	neutral
Änderung in den Hartz IV Regelsätzen? Gericht verhandelt am 19.10.09! Alle Infos Heute 16.10. Im Familienbüro Katharinenstr. 23	neutral
Ich habe den Kanal von CommanderKrieger auf YouTube abonniert (~http ).	neutral
Punkteniveau auf Regio Süd deutlich unter BaWü; Gutenberg- und SK-Cup; 9 Clubs im Wettbewerb; 17 Redner-Saisondebüts #VDCHregios	neutral
3 Grundbe-Dürfnisse jedes Menschen: • Selbst-Wirksamkeit: Effektivität + Effizienz (was + wie)	neutral
"Juuhuu.. ""Schutzengel"" von Paulo Coelho gewonnen..das ist doch mal eine gute Nachricht heute..."	positive
"Das ist ja wie bei der ""Sendung mit der Maus"". #Welterklärung #WwM"	neutral
Harry Potter und die Heiligtümer des Todes T.2 am Dienstag war echt klasse. Und dann nächste Woche nochmal in 3d und demnächst 24h HP! :3	positive
"Handy vollkommen kaputt -_- Sony Ericsson sucks -_-"" Kann ich echt nicht empfehlen! Morgen nach 'nem neuen Ausschau halten *seufz* #Xperia"	negative
Warum macht Microsoft auf WinXP Systemen Werbung für den IE9?	neutral
News des Tages: AIDA baut weiter - diesmal in Japan. In 2016 wird die Flotte mehr als 25.000 Betten umfassen! ~http 	neutral
Bohnen-Tomaten-Gemüse ~http 	neutral
Damals war es das 2. zuhause...	neutral
Kolumbianisches Verfassungsgericht stärkt Rechte der Indigenen auf ihre Kultur und ihr Territorium (pdf; ~http  (cont) ~http	neutral
Ich mag #Anthony nicht @user	negative
heute voll abgekackt zum kotzen ey geht gar nicht	negative
Ich möchte Menschen verfluchen können!!	negative
Jemand interesse an ein Sony Ericsson Satio? 1 Jahr noch Garantie... Melden ;&gt;	neutral
Button-Lösung auf den Weg gebracht: Was haben wir alle geschimpft und kritisiert: Nicht nur bei uns gab es Kriti... ~http 	neutral
#BigBrother Einzug. Wer schaut? #bb	neutral
Enclave90 Patricia RT @user Kann mir mal jemand bitteschön zusammenfassen; was der Scheiß mit Berlin bitte soll? #fickdichberlin	negative
heute zuhause bleiben oder wegfahren.. das is die große frage.. ?!! mhh.. noch unentschlossen.. mhh.. mal sehn	neutral
KnechtPetrus´ Daily wurde gerade veröffentlicht! ~http  ▸ Titelthemen heute: @user @user	neutral
"Slogan der #NPD#SachsenAnhalt: ""Gegen den Strom"".Ich wäre für Koalition mit #Bremer#Linken.Die sind auch #antisemitisch und auch gegen Strom"	neutral
mein Auto fährt trotz Eiseskältet!	positive
Vielen Dank! ab jetzt erhalten sie das Eurovisions Packet für 10;99€ pro Woche auf ihr Handy! #ardesc	neutral
Gelb in sektor zwei	neutral
Guten Morgen Welt ;-)	positive
Bin erst ne Woche bei Deviantart und bekomm jetzt schon Spam-Nachrichten; Yeah!	negative
Auch ich wünsche allen hier weiterhin frohe und gesegnete Weihnachten! :)	positive
Fahrradfahrer aufgepasst: die Berliner Polizei kontrolliert wieder an roten Ampeln!	neutral
Interessant; wie das Internet tief in unsere Kultur eingreift; und wie schwer sich viele damit tun: ~http 	neutral
Führt Kriege gegen andere Stämme und gewinnt Perlen für eure Stammeskasse. Wer schafft es die Statistik mit... ~http 	neutral
Drei Weinhoheiten und ein Geschäftsführer auf ~http	neutral
"Konzertreihe: ""Jazz Metropolitano 2011"" Goethe-Instititut Kolumbien präsentiert jazz colombiano ab 10. Mai... ~http "	neutral
kann ma einer mein freund werden hier ..... fühl mich nach 4 minuten immer noch so alleine :-/	negative
GEWINNE EXKLUSIVE COCA-COLA Light Accessoires entworfen von Karl Lagerfeld ~http	neutral
Clicker+Leinenaggr. Video ~http 	neutral
Eigene Icons für die Windows-Bibliotheken: Jeder in Windows 7 kennt die Bibliotheken. Um sie kommt man gar nicht... ~http 	neutral
einer Erfahrung mit Samsung Wave?	neutral
Jahrgangsstufe 12... nur noch 2 Jahre und dann endlich vorbei... :D :D	positive
.@liberalextrem Die Grundlage der Wirtschaft ist dinglich und findet zwischen Menschen statt. Finanzkapital optimiert nur die Investitionen.	neutral
Nochmal der Hinweis; am 27.09. Wahlparty in Wesel! Infos und Anmeldung hier: ~http	neutral
"Techniknews: ""Office 365"" - Microsoft Office Webapp im Browser - Beta startet heute; Anmeldung kostenlos ~http  @user"	neutral
süße :* ich hab dich lieb und mag dich :**♥	positive
Versandhändler Otto will nach Brasilien expandieren ~http	neutral
Jetzt wisst ihr Bescheid: ~http	neutral
Hallo ihr Lieben (:	positive
Geil !!!!! Neues Samsung Galaxy S 2	positive
ich war noch zu klein um die lage zu begreifen.	neutral
"#Wiegenlied der Woche: ""In stiller Nacht"" von Christiane Oelze. Jetzt kostenlos downloaden auf ~http "	neutral
Na dann guck ich gleich mal beim Juwelier. Ist für eine Mini-Fernbedienung.	neutral
Alle Samstag-Ergebnisse im Amateurfußball: Viele Tore; einige Überraschungen gab es in den Samstag-Par... ~http  #Lustenau	neutral
Überwiegend bewölkt; 17°C; Wind: 2 km/h (11:00) #Luzern	neutral
Haha; das war wohl ein Schock für die armen Turtle Mitarbeiter; aber seht selbst: ~http 	neutral
lichtgestaltung-aachen.de	neutral
Streiche lieber ein Jahr in deinem Leben und gestalte die nächsten 365 Tage neu.  Franz Kern	neutral
Unsere amerikanischer Partner ~http 	neutral
Was denn auf #MSN heute los??? ~http 	neutral
Nachrichten Krefeld Krefeld - Niers-Express: Fünf Wochen Ersatzverkehr mit Bussen ~http 	neutral
was soll #bchh09 überhaupt sein? Ja ich bin unwissend....	neutral
Neinnnn bitte nicht...~http 	negative
Das neue; sichere Formel-ADAC-Boot mit Sicherheitscockpit bei einer seiner ersten Testfahrten am vergangenen Sonntag. ~http	neutral
"Falsch er wurde durch das iPhone tracking gefunden! “@Neureutheralex: Bin Laden aufgeflogen weil er Playstation von Sony gespielt hat und.."""	neutral
Der erste Tag ist rum und die Arbeit gefällt. :-) #s2	positive
Ich habe ein YouTube-Video zu meinen Favoriten hinzugefügt. -- Justin bieber performan... ~http	neutral
Nur noch ein paar Std ;)	positive
Neue Frisuuuur xD und ich seh verdammt gut aus :P	positive
Sind die Server von Sony (zum online spielen) immer noch down; habe neulich mit nem Kollegen gespielt! Gruß Marius #Sony #Server #Frage #PS3	neutral
"Wird ""2001 - Odysee im Weltraum"" von Samsung gegen iPad am LG DD ins Feld geführt? ~http "	neutral
"Jasmine hat für euch vorab ""Das verbotene Eden - David und Juna"" gelesen und rezensiert ~http "	neutral
Kennt jemand den Rekordläufer mit der Nr. 18019 am Berlinmarathon? #sollstarksein	neutral
New Post:  Samsung Galaxy S Plus ab Juni in Deutschland erhältlich ~http	neutral
else.schwarz Rechtsanwälte - #Wiesbaden | Beamte #Mobbing Bauen & Denkmal; #Umwelt; Fachanwalt Verwaltungsrecht ~http 	neutral
Erinnerung heisst das neue Kunstplakat von Quarrtsiluni. Auch im Lusorium-Stream auf Flickr: ~http 	neutral
Square Enix verschiebt ‘Final Fantasy Tactics’ weiter nach hinten ~http 	neutral
Misikalische Früherziehung – Let's get loud! ~http 	neutral
Der Schatz des kolumbianischen Departamentos Córdoba: Lorica - Lebensfreude am Ufer des Río Sinú - Fotogallerie: ~http 	neutral
Die Aussichten für Morgen: Da haben wir 2-3 Follows im Norden; und 1 Retweet im Osten. Am Abend ziehen Unfollows durchs Land.	neutral
24h #Konsum: JA zu liberaleren Öffnungszeiten der Tankstellenshops ~http 	neutral
HEUTE 01.05.2010 danceON Reggae-Party mit green skin movement Start 21:00 Uhr Eintritt 2€ (Vereinsmitglieder frei)  ~http 	neutral
LOL ist toll! ~http	positive
Nie mehr ohne dich-ich liebe dich :-*	positive
Feierabend	positive
Jetzt Hunger.	neutral
Aufsteiger Platz #3: babywalz Anti-Rutsch-Socken ~http 	neutral
„Warum sagst du das nicht vorher; warum erst jetzt? Was tun wir denn so schnell? ...“ Daily Dueck Aktuell ~http  via @user	negative
Was haben ein Smart; ein dicker Audi und ein Tischlerei-Transporter gemeinsam? Nen fetten Crash vor meinem Bürofenster. Sind alle wohlauf!	neutral
Hier mal ein netter spruch für unsere Vegetarier..Die Schweine von Heute sind die Schnitzel von Morgen!	neutral
Google löscht Android-Apps aus der Ferne ~http 	neutral
Frohes Neues ! ! ! Hoffentlich seit ihr alle schee nei gerutscht^^	positive
Hat mir jemand einen direkten Vergleich zwischen dem Samsung Galaxy s i9000 und dem LG Optimus Speed? Welches ist zu empfehlen?	neutral
AUCH NEU! ~http 	neutral
Lemmings auf WebOS? Sony (Rechteinhaber)  schiebt den Riegel vor! #webos #palm #pre	neutral
1;60 männlich rote haare etwas dick hasenfresse und n iq von mettwurst und ne stimme wie verona feldbusch! Die nervige aushilfe!	negative
Habe gerade ein Flugzeug geflogen. Also im Simulator am PC. Werde jetzt Pilot!	neutral
NEWS von der Weltreise: Laos ~http	neutral
aber der mond..:(	negative
Suncase Ledertasche für Samsung Galaxy S2 ~http 	neutral
Neue Termine für die Social-Web-Roadshow! ~http  ~http 	neutral
"Entdecke Windows 7 bei unserem ""Deploy & Win"" Wettbewerb; welchen wir bald gemeinsam mit Microsoft starten werden - soon @ ~http "	neutral
Passend zur wahl am so RT @user Alles Infos zu “#servergate” – Polizei beschlagnahmt Piratenpartei-Server. ~http 	neutral
Apple ist der neue Smartphone-König - Finnen rutschten im Quartal auf 3. Platz ab. Samsung nun Branchenzweiter. ~http 	neutral
Technik der Zukunft ; wie sie sich Microsoft vorstellt:   ~http 	neutral
Zum #Plagiat Vorfall: Selbst der erste Absatz findet sich woander wieder. Schon dreist. ~http 	negative
"Rheinbergers ""Abendlied""; gesungen vom SWR Vokalensemble Stuttgart. Jetzt kostenlos herunterladen auf ~http "	neutral
Microsoft - Bing und Google; der ungleiche Kampf der Suchmaschinen oder was ist los mit Bing? - ~http 	neutral
Die Antwort für Microsoft ~http 	neutral
Das Foto Konijnenberg Kenner-Angebot: Die Sony DSC-HX5 Kompaktkamera diese Woche für nur € 199;00: ~http	neutral
Es ist traurig;wenn sich zwei Menschen einig darüber sind;dass sie nichts mehr miteinander zu tun haben wollen.	negative
Heute muss mal wieder ein Eintrag rein. Es ist ein geiles Gefühl wenn man auf den Knopf drückt und es 8 mal die Sek. Klack macht! Wahnsinn!	positive
Wiesbaden sucht einen Projektleiter im Microsoft Umfeld (m/w) ~http 	neutral
Wenn #Weihnachtsmänner #Glüwein trinken;....~http 	neutral
#Weihnachten #Gutscheine #Kanutour auf der #Fulda zum #Sofortausdruck bei KanutoursFulda ~http	neutral
Die Liebe ist mein Lebens-Navi	positive
ich hasse ich hasse ich hasse ich hasse wen auch immer; am besten alle !	negative
Endlich konnte ich meinen Schweinehund überwinden und mich an das Kleid machen... naja... ok... ich hab den Stoff zurecht geschnitten XD	positive
#Suche Visa für Strandshooting auf #TfP Basis. Bitte melden Please RT	neutral
Ich spiel grad Nintendo DS :D	positive
Wie viele Zugriffe müssen das wohl sein auf #gameone damit der Server einknickt?	neutral
"Tipp! Käthe #Kollwitz #Jubiläumsaustellung ""Paris bezauberte mich"" bis 30.Januar 2011 verlängert. ~http "	neutral
Zeigt her Eure Lieblinge - Parade 7 Woche ~http 	neutral
Finest-Electronic-Beats KLANGRAUM FM NÜRNBERG / FÜRTH 106;5 MHz - ERLANGEN 106;2 MHz KABEL DEUTSCHLAND 103;9 MHz - KA… ~http 	neutral
Zehn lustige Domainnamen ~http  #domains #seitennamen #seitenadressen #humor	neutral
Urheberrechts-Trolle in der Wikipedia ~http 	neutral
Ich ziehe um  ~http 	neutral
Irgendwas vom Rest? - Ja; genau! #Detailliebe #Domian	neutral
Post von heute 06 September 2011 ~http	neutral
Nacht durchmachen; weil ich eben angefangen habe einen 5-seitigen Bericht zu schreiben; den ich morgen abgeben darf. Na das wird n Spaß -.-	negative
Nintendo Fans aufgepasst. Eine frische Review zum bald erscheinenden Nintendo 3DS auf loveforgames.de &lt;3	neutral
Der Marketing im Sinne des Marketing... #TippfehlerThursday #fail  #Uni	neutral
Spieltag 33 Gesamtwertung:  @user 320 Pkt. @user  318 Pkt. @user 315 Pkt.	neutral
eBook-Reader Sony PRS-300 in verschiedenen Farben für 99;90 Euro bei Comtech ~http 	neutral
Zitat: Sagst du’s mir; so vergesse ich es. Zeigst du’s mir; so merke ich es mir. Lässt du mich teilhaben; so verstehe ich es. (China)	neutral
Morgen gehts vielleicht nach Hamburg :)	positive
Nichtraucher werden; ohne Entzugserscheinungen und ohne Gewichtszunahme. Das ist möglich! ~http 	neutral
MÜNCHEN: Psst! Heisse Ware aus dem Knast! Neu auf ~http	neutral
Frauen kann man doch echt nicht weiter trauen als man sie sieht ... schlimm sowas ...	negative
@KoelnFormat: Mein #eBay account feiert 10jähriges. Und euer so? Gute Frage; muss ich nachschauen. Gruß Frank	neutral
Entwicklung hocheffizienter Elektroden für die großtechnische Erzeugung von Wasserstoff aus regenerativen Energien ~http 	neutral
twittern auch leute; denen es schlecht geht? /via @user - Spannende Frage nach Qualität und Bedeutung der Sozialbeziehungen im Netz!	neutral
Apple verklagt Samsung auch in Südkorea - Vorwurf des Ideenklaus nimmt nun internationale Dimensionen an. ~http 	neutral
Heute Abend kommen etliche seltene Mikrofone auf den Reprotisch! #Robinsound	neutral
Premiere: 1. Verkaufsspiel in Wien. Start 16:00 Uhr im Hilton Plaza ~http	neutral
".@svp_wahlen_2011 Wahlversprechen hier unterzeichnen ~http  ""SVP ... fordert echte Entlastungen für Wirtschaft & Konsumenten"""	neutral
Guten morgen. Endlich mal ein guter start in start in den tag.	positive
Verkaufe einen Nintendo DS lite cobalt Blue mit cyclo ds Evolution für 200€ VB.(4 Monate alt)  ~http	neutral
Ach hab ich lust heute :___:	negative
Seid ihr am Nintendo 3DS interessiert? Morgen wird ein Artikel über den neuen Handheld veröffentlicht. Seid gespannt!	neutral
Ach was für ein schönes Video ~http 	positive
[Gerücht] Microsoft zeigt Windows 8 auf Samsung-Tablet: Schon in wenigen Tagen (am 13. September) will Microsoft... ~http 	neutral
Yahoo-Chefin per Telefon gekündigt. Hm ... dass dazu nicht das Internet genutzt wurde; zeigt Yahoos Niedergang ganz deutlich ...	negative
soo...um circa 10 uhr muss ich erst am bahnhof sein und kann demnach noch was chillen...:D	positive
gleich essen gehen; und dann ab nach frankfurt und von dort aus nach griechenland :)	positive
Audi balanced mobility - mit Wind erzeugtes e-Gas soll Audi antreiben ~http 	neutral
Twitter - lange vernachlässigt; aber es war einfach so viel privates los *G* ... Trotzdem viel gelesen in der Zeit siehe Blog ;)	neutral
+1;5 wodka!!!!!! Männer vergessen einfach alles!!!!	neutral
Ich bin gerade ~http  beigetreten mit 3 anderen Leuten und 2 auf Kamera.	neutral
Die #Piraten Friedenau werden auf dem Cranachstrassenfest vertreten sein; am Samstag; 21.05. ab 14 Uhr	neutral
Am Sonntag trifft sich um halb zwei der Arbeitskreis Öffentlichkeit wegen der Erneuerung der KjG Homepage und danach die PL =)	neutral
Liveshopping: adidas schuh bei Hervis statt € 90 um € 60; zu finden auf ORF.at (rechts); gratis versand	neutral
Super Wetter! Heute abend gleich mal noch ins #Freibad nach #Nagold ins kühle Nass!!!	positive
Schade; dass du gehst. Es war so schön; bevor du kamst.	na
Kaum gibzsnixim fernsehn sind alle online	neutral
Biathlon ist ja schön und gut aber hier zu rumzuschreien naja vllt sollte meine mutter mal zur waffe greifen	negative
nächstes jahr schicken wir mannymark und die atzen da hin dann kommt mal etwas krassere stimmung auf :D   #ardesc   #esc	positive
Ice Age 3 war echt lustig. jetzt muss ich erstmal koffer packen weil es nach hause geht	na
Sicherheitslücke auf Webserver der Schufa - heise online ~http   ´Saustall´ auch hier!	neutral
GERADE SITZEN!	neutral
für jeweils 800 Microsoft Points frei kaufen?! O_o	neutral
"‎""Immer mehr Senioren verschwinden spurlos im Internet; weil sie ALT + ENTFERNEN gedrückt haben"""	neutral
Kein #Wunder; dass die #Pilotenkoffer #Ladenhüter bei #ALDI sind. Sie sind unvollständig; denn es fehlen die #Piloten im #Koffer.	neutral
Donnerstag: Alle Websites sind wieder online. Probleme (hausgemachter Art) sind beseitigt.	neutral
Vergesst den Social Media ROI!  ~http 	neutral
in chronologischer reihenfolge; billy talent; deichbrand festival; blink 182; volbeat. bam. fuck you!	neutral
es ist unglaublich ich habe Mathe gelernt... schon fast erschreckend	positive
Blaulichtsteuer; Bräunungssteuer ... unglaublich; wie einfallsreich man in Deutschland ist! Immerhin darf man noch steuerfrei kacken	negative
Welche Katastrophe? @user Drei Jahre hattet ihr Zeit um solch eine Katastrophe nicht zu veranstalten. Peinliche Nummer! @user	negative
Warum beklagen sich eigentlich alle über den Herbst? Von wegen schlechtes Wetter und so. Ich liebe den Herbst. Ist die schönste Jahreszeit.	positive
Dann haben mir heute B-War mit Jugendstiel für das SESS zugesagt...ich freue mich riesig!	positive
Mein Gott... der volle Kontrast zum #Wetter Gestern.. Zwar Nass aber nicht all zu kalt.......	na
Ein schöner Praxisbericht über den Sinn von Controlling auch für kleine Betriebe:... ~http 	neutral
Nachdem es ja bei Gomez mit der Rechnung Gomez Avatar rein; Gomez Tore funkte; jetzt neuer Anlauf: Ama Avatar; Ama Tore; Klassenerhalt #SGE	neutral
ralf gib alles:D	positive
Was bitte schön ist das??? ~http 	neutral
Also plume ist im Moment echt nicht zu gebrauchen... #SlowAsAss	negative
offenbar gefällt es petrus; mich dabei zu beobachten; wie ich alle 43 minuten den wäscheständer rein/raus trage.	negative
der Deniz ist cool folgt ihn denizkoekden #ardesc	positive
Bin auf 'ner Party. Überall Chips und so ^^	positive
Ich fühl mich hilflos - bleibe stumm Sarkasmus wäre jetzt nur dumm.... #Japan #AKW	neutral
Du kennst Thienelt Echte Kroatzbeere nur aus Erzählungen? Dann wird es aber Zeit; dass auch du Thienelt Echte... ~http 	neutral
haut jetzt mit Ida Corres ordentlich auf die Scheiße ; muss mal wieder; ein hoch auf die Mäünner !!!!	positive
Boah; ich glaub ich esse diese Woche kein Fleisch mehr :( läßt stark nachdenken #deutschland isst #ARD	negative
#1: Samsung EB-K1A2BEBEGSTD Akku mit Gehäuserückseite für Galaxy S II: Samsung EB-K1A2BEBEGSTD Akku mit Gehäuser... ~http 	neutral
Ich werde den Blick senken; wenn #Schavan im Sommer #Nacktscanner präsentiert... wäre das nicht eher ein Modeljob? ~http	negative
Nix im Stiefel .... hätte ihn wohl doch vor die Tür stellen sollen.	negative
So.4 Tage studio mit der Band sind rum. Anstrengend wars. Aber sau geil. Wer ist der beste rapper in town. Koby. Grins	positive
Ich mag ein YouTube-Video. -- Fiesta Online - Gildentreffen Anfang April 2010 ~http	neutral
k 3 Herzinfarkte oder so. Man man man #Bayer macht mich fertig :/	negative
%VIVE TWITTER ~http 	neutral
Auch wenn ich wüsste; dass morgen die Welt zugrunde geht; würde ich heute noch einen Apfelbaum pflanzen.	positive
Eben über n neues Buch gewundert Toll was die sich einfallen lassen ~http 	positive
Wow; was für ein hübsches #Läufergadget! Die #Sport Watch von Nike misst irgendwie alles & besitzt noch ein TomTom-GPS: ~http 	positive
Herzlichen Glückwunsch Borussia Dortmund. Wir sehen uns nächstes Jahr auf diesem Kanal wieder ;)	neutral
Spruch der Woche: Nichts ist entspannender; als das anzunehmen; was kommt. (Dalai Lama)	neutral
Der Mohr hat seine Schuldigkeit getan: Olaf Ernst verlässt Springer: ~http	neutral
Guten Abend!	neutral
sooooooooooo! die kleine lisa geht jetzt auch schlafen! gute naaaaaacht!!! =)))	neutral
Du bist weg von mir und somit bleibt mir nichts.	negative
Internetauftritt von Bordell untersagt: Die rheinland-pfälzische Landeszentrale für Medien und Kommunikation (LM... ~http 	neutral
Derbe viel erledigt heute... jetzt noch ein Stündchen Sonne am Park Fiction!	positive
Guten Morgen liebe Twitterer	neutral
Der Herbst ist eine schöne Jahreszeit; einer meiner Liebsten ^^. Ich mag diese regnerische;nebligen Tage. #fall	positive
irgendwann schlag ich se ey xD	neutral
Leider nur für US-Bürger: Bitcoin Print Lab ~http  (via @user)	neutral
omg xD warten is unmöglich!!	negative
LIVE !!! MORGEN!! SAMSTAG WIRD EIN HAMMER!! AB UM 10 IM FUCHS UND ELSTER!! AB UM 2 IN DER WILDEN RENATE!! NICH VERPASSEN!! LUSTNLOVELOVESYOU	positive
Wer das liest ist blöd.	negative
ich möchte nach österreich. jetzt..	neutral
Italien; die Währung hier hab ich gehört; sind Lehrer. Habe 4 an Board; hoffe; das reicht	neutral
#guttbye; irgendwie fehlt jetzt was...; ach was; jetzt weiter mit Gaddafi und wie sie noch alle heißen...	neutral
"Positives Wort des Tages ""ANREGEND""; mehr unter ~http "	neutral
NurNoch6Tage 14Tage #Filme;#GamesAusleihen ~http  Habe ich selbst gemacht;ohneKosten;voll toll! ~http 	positive
Leute! Ist hier oben ein Platz. Mein Gehege war schon klein.	positive
Verrückt. Wie manche Droge einen zerstören kann. ~http  #drogen #fotografie	negative
Will gerade mit dem zeitraffer anfangen finde aber meinen Stativkopf nicht.	neutral
jetzt ist gerade wieder ne down phase..stress mit den eltern; also ich meine wer hat das nicht..ne? Aber irgendwann wirds zu viel..ganz klar	negative
Und ich arbeite weiter und weiter an meine Website. Ich bin schon recht zufrieden mit ihr; das Farbschema ist jetzt auch ganz ok.	positive
volle Kanne durch mdl.Prüfung gefallen. Kein Sprachfluß. Hallo; schomal was von Stausee gehört?	negative
jetzt aber schnell @user Jahresvorrat zu gewinnen! Werde Fan auf Facebook und nimm teil! #kusmi1year ~http 	neutral
"ich lebe angeblich in einer parallelgesellschaft. ""jetzt lass die soziale randgruppe in ruhe"""	neutral
Der alte Wildeshauser Bahnhof muss langsam renoviert werden  @ Bahnhof Wildeshausen ~http 	negative
Wochenende war produktiv! Neben diesen beiden 15kg+ fischen konnte ich noch 3 weiter carp´s bis 12kg auf der haben... ~http 	positive
#DieWahreTabelle: ~http  | Rückrunde & Form: ~http  \☺/ #AusschneidenUndEinrahmen \☺/ #Bundesliga #FCN	neutral
Was lernen wir aus der Sache mit MS uns Skype..! keine Macht  Microsoft und Appel lernt mit Alternative Betriebssysteme umzugehen	neutral
Petrow wird hoffentlich bestraft. Auch wenn das Schumi nicht viel nutzt.	negative
Yippiyayee! Über 2.000 (!) Restaurants bei Lieferheld! ~http 	neutral
freitags kein fleisch? was essen die dann? glühbirnen??#simpsons #katholikenspinnen	negative
Firwat schwätze de klenge Schmittchen eigentlech franseisch mat der Police? Kann heen eis Sprooch net?	neutral
Vorteil vom Home Office: Bei Web Seminaren Bier trinken...	positive
Ich hab getanzt; ich hab geweint; ich hab geschrien vor Glück.	positive
von unten nach oben; aus dem dreck ans licht; der löwe der strasse; wie phoenix aus der asche; ich flieg!	positive
Rockin Heaven is ein soooooooo geiler Manga &gt;__&lt; leider wirds neu aufgelegt und kann den Manga nicht lesen; also heißt es via Mangafox lesen	negative
zorolo verlost einen Samsung 3D-Fernseher; weil @user (~http  weiß; was Fans glücklich macht!	positive
Meine Selbstgespräche machen irgendwie nicht so viel Spaß; wenn Mama mit im Zimmer sitzt und mir antwortet.	negative
Lena hat mich geflashed &lt;3 #ardesc	positive
Die angenehm zarte Reinigungsmilch ist wieder da: ~http	neutral
Der/Das Blog. Hauptsache; man hat mal drüber gebloggt. Und nat zuhauf kommentiert ~http  /v mehrwertzone cc @user ;-)	negative
So!Ich hab zwar gestern nix verstanden...aber naja los gehts ab in den neuen Tag!	neutral
Als Schalker kennt man diese Situation wenigstens schon #ger #s04	neutral
"Buchtip des Tages: Alan Baklayan:""Parasiten-Die verborgene Ursache vieler Erkrankungen"" sehr lesenswert!"	neutral
Kauder versucht jetzt gerade Märchen zu erzählen. #CDU	neutral
Ich mag ein YouTube-Video. -- Rauchbombe :D ~http 	positive
Sommerschüchen!!! (@ Audi Zentrum München) ~http 	neutral
Yippieh - jetzt zur Aftershow!!:)	positive
"Abmahn Abzocker immer dreister: Lizensgebühr für ""ABI"" ~http "	negative
Endlich Schnuppi ist wieder da und ich kann mit ihr schreiben	positive
Baretto verschießt.	neutral
Also so gings mir bei 24 Stunden fahrt gut ! ~http 	positive
Wie die Zeit vergeht; wenn man Spaß hat.	positive
/  \   /    \  /       \ /_____\ |          | |        _| |____|_|  Nur bedingt zu empfehlen: @user  #ff	neutral
Ich war gestern frech und muss heute vorsprechen beim Chef.	negative
M4 hatten einen erfolgreichen Tag bei CiTi TV Saarbrücken und Radio Pirmasen! Morgen mit Monrose bei Stars on Stage in Pirmasens; 21.00 Uhr!	neutral
Ich rede mit meinen Auto wie David Hasselhoff; doch mein Audi A6 will mir nicht helfen! ;D	neutral
So genannte Ehrlichkeit ist manchmal nur versteckte Grobheit.	negative
WM Südafrika 2010 - Wer möchte hin?Registriere Dich jetzt und nimm exklusiv am WM Gewinnspiel teil!~http	neutral
Heute Nacht in Liebstedt nem funkelnagelneuem Audi A4 alle 4 Reifen geklaut und Auto aufgebockt.Von wegen Ruhe aufm Dorf..	neutral
dass du keine andern Sorgen hast; @user :)	negative
Drei Bazillen einer Frau unterhalten ~http  die Erste: Ich leb im Mund; da kommt jeden Tag zweimal ...~http 	neutral
Unser kleiner Engel (Bendicta) freut sich TÄGLICH auf Eure Stimmen beim Fotowettbewerb. Danke ~http 	positive
Psst... noch nicht weiter erzählen. ~http  ~http 	neutral
sprint! ich will das sprintfinale der männer endlich sehen!!	positive
"Hurra das Ebook zu ""Lügenwahrheit"" ; dem Mobbing-Krimi ist da: ~http "	positive
Arbeitswoche - der Wort gewordene Schlag in die Magengrube.	neutral
Ich will sportlich glatte Beine und bei @user die Nintendo Wii und den Braun Silk-épil 7 Dual #gewinnen!	neutral
#SDP - Kontrastprogramm am 10.12. Wird des Fett!	positive
Wirtschaftsminister Rainer Brüderle kann von mir aus nach Fukushima auswandern. Ist ja nicht so schlimm da….	negative
Die schönsten Ideen zum Garnieren & Verzieren für jeden Anlass - von . - Naumann Und Goebel. ~http 	neutral
Was habe ich heute gelernt: Wie meine Kipp-Funktion an meinem Schreibtischstuhl an mache. XD	positive
Immernoch auf Callejon warten xD	negative
Erster Tweet vom Samsung Wave :D	positive
Bin wieder zurück aus Hamburg City! :)	neutral
Wenn auf dem Microsoft Stand irgendwo Stau ist; dann vor dem Office Kino. Carolin hat sich für unsere nächste Folge... ~http 	neutral
Judtih Merchant ist jetzt angereist und von ihrer Krimisuite ganz hin - und - weg! Unsere Gäste sind schon ganz... ~http 	positive
guckt grad den schlechtesten animierten film EVER :D :D	negative
Filmliebhaber aufgepasst! Nike versteigert McFly's Schuhwerk in Neuauflage für einen guten Zweck! ~http	neutral
Was ist Microsoft Works? Ein Widerspruch!	neutral
So; war ganz schön erschöpft - jetzt: Mein dritter Tweet!!!	neutral
So; ich geh jetzt wählen! =) Wen wird nicht verraten =)	neutral
aarrrghhh...ich seh nur noch kartons und müllsäcke...rettet mich!	negative
Social Media Fail: Von Fehlern lernen | MaWoGo GROUP ~http 	neutral
BlackBerry Enterprise Server 5 hat mir gerade fünf Stunden meines Wochenendes geklaut! Danke #RIM	negative
man... warum kann Baby nicht wenigstens das Princess Drop von der Sale Seite nehmen? Hab mich eben schon wieder grundlos gefreut -.-...	negative
Putty is geil ... 3 Verbindungen abgebrochen ... hauen die 3 Teile meinen i5 auf 100% Auslastung ... wtf! #putty #fail	negative
was soll das denn jetzt heißen	negative
Ein vorverlegter #ff damit er wieder mehr twittert an @user :D also meine Lieben; folgen; folgen; FOLGEN!!!	positive
Wehe; der VW Wolfsburg holt ›meinen‹ Hans Meyer ... ☹ #FingerWegVomFeuerwehrmann	neutral
bin schlafen; leute. gute nacht&lt;3	neutral
Busfahrer muesste man sein. Da wird man von der Leitstelle vor Blitzern und Radarfallen gewarnt ;) #Frankfurt	positive
Ne Stunde schlafen; dann nen guten EIndruck machen &amp; dann in die Stadt! :D	positive
Ich habe ein YouTube-Video zu meinen Favoriten hinzugefügt. -- Christina Aguilera Nati... ~http 	neutral
Grade CS gehabt kurz vor dem Erguss kackt mir Skype ab ich werde Microsoft anzeigen!!	negative
Hier fließt der Mozzarella in Strömen.	positive
Leb zieh dich warm an wir kommen und rocken dich platt @user wird gemacht ich tanz für dich mit ;)	positive
Früher konnten mich nur ein paar Nachbarn nicht leiden. Seit ich bei Twitter bin; hassen mich Menschen aus aller Welt.	negative
UFFIE UFFIE - wäre ganz nice so	neutral
Nicht jeder kann immer der beste sein - heute bin ich's :)	positive
macht weiter mit: ~http  der superpoll zur #ahrens-affäre in der #lehrter kleinstadt. wozu der #obi die menschen bringt	neutral
schlafen...xD	neutral
ich werd jetzt schlafen gehn.. guuuuten nacht.. (:	neutral
Kein Aprilscherz! Bis Sonntag; 03. April 2011 nur 2;50 Euro Versandkosten bei Kotte & Zeller. Mehr unter ~http 	neutral
bei dem wetter kann  man ja nur OC Lieblingsfolge Regen gucken; nenene	negative
‎1. Urlaubstag: nuja mal schauen mieses weTTer erstmal zocken und kaffee trinken dann weiter schauen nachmittag bissl mit mausi sein &lt;33333	positive
Aha... iPhone und handschuhe funktioniert nicht #manlerntnieaus	neutral
343 neue Tweets? Mehr nicht? Muss mal mehr followen :3	neutral
Neuer Auftrag: Falterchaos [W1] - ~http 	neutral
Neuer #Computer-Schädling braucht keine #Sicherheitslücke; um sich zu verbreiten - ~http 	neutral
Grausiger Fund in Mexiko: Sechs Tote werden nach einer Hinrichtung in einem Stadion aufgefunden.Foto: dpa bildfunk	neutral
Sie schreibt; liebt Sci-Fi und die Katzen; mit Ihr gibts immer was zu schwatzen #FF_@HannaJulian	positive
(zitat) Edward aus Twilight ist kein Vampir! er isst keine Menschen; er lebt im Wald  und er glitzert... Edward ist eine Fee!	neutral
Dominic in Inglitsch und sein Schummler; I like!! ~http 	positive
Jetzt muss ich die ganze Zeit Cartoons gucken; damit sich die Obdachlosen Kinder nicht langweilen	negative
Im letzten Adventstürchen verstecken sich 10 MNY LEs  und eine Nintendo Wii plus Dancing Stage / Hottest Party ~http  =)	neutral
Meine Mutter meint ich soll mir die Haare blond färben. Sie werden rotblau! *o*	neutral
Mein neues Soloprojekt VOM LEBEN GEZEICHNET gibt es ab sofort auf ~http  zum kostenlosen Download! Herunterladen und lieben ;)	positive
"Schatz; schläfst du schon? - ""Ja; sie schläft schon. Gruss Peter"""	neutral
Schöne Entlassungsfeier; nun Abi-Zeugnis in der Hand und später auf dem Weg zum Hurricane	positive
Naja; wenn Gutenberg nicht mehr Doktor ist; ist es nur fair; dass ich jetzt Bachelor bin; oder?	positive
Dann können @user und @user ihre Propaganda-Accounts ja jetzt auch löschen; oder? #ltwsa #ltw2011 #lsa #NPD #verhindert	negative
Wahlergebnisse schau ich auf ZDF immernoch viel lieber ;-)  Die FDP in einer Ampelkombi wäre nicht sonderlich prickelnd...	neutral
So Formel 1 am Sonntag hat ein Ende - und was für eines!	neutral
Das mit dem Liebeskummer vergeht wieder. Der Schmerz ist jetzt nur so groß; damit du schneller vergisst; wie schön deine erste Liebe war.	positive
Liebes Motorlämpchen da bist du ja schon wieder? Du magst mich ? Ich ignorier dich weiter ! #Fail #Peugeot	neutral
Haarband; Adidas Jacke und Zahnspange :D:D:D  iloveu	neutral
Der Herzbube und Berlin schienen das gleiche Ziel zu verfolgen; das Finden von Marlov. Und ich war eine Marionette in einem dreckigen Spiel.	negative
Googolopoly... wer baut sein Googleplex auf Microsoft und Yahoo? Wer bleibt im 404 Error hängen?  ~http	neutral
Herzlichen Glückwunsch Daniel Schuhmacher! ~http  - eigener Song mit Gänsehautfeeling:)	positive
Junge Hunde sind wie Kollegen. Wenn sie mit besonders glücklichem Lächeln in den Raum traben; haben sie Dir heimlich wo reingeschissen.	neutral
Gleich..ähhh..wiedeer bei Cinni ;D	neutral
begrüßt ganz herzlich Andrea Meyer - Willkommen!	positive
Habe Gruppen-Ex von Steffi von Wolff zu Ende gelesen und 5 Sterne dafür vergeben; klasse! @user ~http 	positive
Kindergeld doppelt kassieren = Steuerhinterziehung ~http 	negative
Sehr; sehr traurige Lebensgeschichte. ~http 	neutral
heute cocktailtrinken in der leipziger city ;)	positive
gute nacht welt!	positive
Freude: Samsung Galaxy Tab - die Vorserie verspricht eine Alternative zum IPad ~http 	positive
Exklusive Kreuzfahrt-News des Tages: MSC MAGNIFICA fährt 2013 ab Hamburg! ~http 	neutral
Flash Banner an sich sind ja schon wiederlich; aber dann auch noch mit Ton und autoplay?	negative
Flensburg im Schnee und Eischaos und dazu der richtige Song zum Fest ~http 	neutral
weiße fingernägel sind der shit.. xD xD	negative
Sorry für 1 Sekunde Unprofessionalität. Aber Apple vs. Samsung vs. Google vs. Nokia vs. Microsoft vs. Lodsys vs. PayPal fängt an zu nerven.	negative
Klassisches Festivalwetter in St.P. #frequency ~http 	neutral
Das Samsung Galaxy Ace als MiFi hat was.	neutral
Unsere neue Homepage ist online! ~http  Wir freuen uns über Ihr Feedback!	positive
"Vielen Dank für das KonFerenz-Special von der Podfee Annik Rubens zum Digitalrelease von ""In Flagranti""! ~http "	neutral
guten morgen zusammen ersma ;-)	positive
etwas zum Träumen  ~http 	positive
Stallon rief sie und sie kamen. Dieser Film verspricht ein richtiges Actionfeuerwerk zu werden. ~http 	positive
Sonne = Chillen; Chillen = Entspannen; Entspannen = Twittern	positive
endlich gibt es knackige URL's für Xing; schick auf Visitenkarten und Signaturen etc.. schnell die Eigene sichern !! ~http 	neutral
Ich habe 20 Millionen Franken für Dro... ausgegeben. Ich habe meinen Audi R8; mein Flugzeug und mein Haus durch die Nase gezogen. ;-)	neutral
Ich glaube ich jetzt funktioniert das mit dem Internet	neutral
Dieses Video musst du dir ansehen! -- Hitler gegen Microsoft - Linux! ~http  via @user unbedingt anschauen !! ^^	neutral
Am Ende der Microsoft PK dieser monströs wirkende Teaseranfang. Aber dann die Ernüchterung....Nur ein Halo	negative
Gedichte-Freude:    Manfred H. Freude ~http 	neutral
Kultur-Tipp: Täter auf freiem Fuß! Sammel Hinweise am #Tatort und finde den Bösewicht; beim Live-Krimi in #Hamburg! ~http 	neutral
Suuper: Postit-Motivcontest an Bürofenstern ~http  /v @user	positive
#Guttenberg An alle Doktoranden TK hat euch doch gutes getan ab jetzt werden die Dr-arbeiten sicherlich genau geprüft	neutral
Und weil ich genau WUSSTE; dass @user gleich online kommt; bin ich noch nicht im Bett; nämlich.	neutral
Wie oft hab ich den schon gesehen und nur Paris Hilton erkannt?! -.-	neutral
Neuerscheinung und gleich die Nr. 1: LuuBooks Libreka E-Books und ~http 	neutral
Mom abholen :) (@ Oldenburg (Holst) Bahnhof) ~http	positive
Nachdem der Sommer am Sonntag ja wieder ein Sommer werden soll feiern wir heute Abend unseren elektronischen... ~http	positive
Erstmal meinen Schreibtisch umräumen hier =)	neutral
Nein Mann; ich will noch nicht gehn'; ich will noch 'nen bisschen tanzen!	neutral
Benward ;)	neutral
New from Kitejunkie.com KLB Meisterschaft 2.Lauf ~http  by Moritz	neutral
tschöss isch das widr schnäll umegange..	na
Ich habe ein YouTube-Video zu meinen Favoriten hinzugefügt. -- Despicable Me -  Agnes HD ~http 	neutral
schön das es lan-kabel gibt; die gefühlte 10m lang sind!	positive
Wobei Appel meiner Meinung auf den besten Weg ist ein 2 Microsoft zu werden	neutral
Endlich halte ich iPad in den Händen. 5 Tage zu spät; danke #TNT	na
Gute Idee. Würde glaub' ich nichts nützen. RT @user @user (Elternteil? Hm; hört sich irgendwie nach Zerstückeln an.)	na
steht auf den Werbespot Song von Adidas Originals --&gt; Madcon - Beggin!!! ~http 	neutral
Wenn Justiz und Gesetzgebung die #Mediation wirklich wollen; sollte so etwas hier eigentlich nicht sein: ~http 	neutral
Sehr schön: Worst Case ist keine Wurstkiste! ~http	neutral
...werde heute mal ein wenig entschlacken. Der #Apfelwein ist schon kalt gestellt.	neutral
s git kei schlächts wätter; nur schlächti kleidig. schints	neutral
Da hab ich aber eine schöne Hilfe ~http 	neutral
Anschreiben ;*	neutral
Schön beim Bäcker gefrühstückt. Kalter frisch gepresster O-Saft is auch ne feine Flüssigkeit.	positive
wärmt sich in ihrem gemütlichen zimmer auf :)	positive
yoga und blauer himmel!	neutral
So nämlich.	neutral
#Karlsruhe wird zur Nerd-Zone! ~http  (via @user)	neutral
Serial Dad; erster Film heute; war bis auf das Ende gut. Leider hat das Ende den Film durch wirre Präsentation und Inkonsistenz abgewertet.	negative
Kann man immer noch nirgendwo FÜR Klimaerwärmung unterschreiben?! Ich hab die Schnauze voll vom Schnee!!!	negative
Ist meine Timeline eingeschlafen?	neutral
as heißt der sieht 'so' viel besser aus?:O ich hab den irgentwie nch garnicht richtig gesheen...:O	neutral
OMG @user hat einen Transvestiten im Schlafzimmer!! XD	neutral
Mein neuer lieblings #flighttracker :  ~http	positive
My Bloody Valentine ist besser; als ich dachte: ~http 	positive
Läck isch das geil mit em Pampersbomber Audi im Schnee z'fahre. #Understatement :P	positive
Ich bin mir sicher es ist leichter mit merkel zu sprechen als mit jemandem bei der tickethotline #s04	negative
Avril Lavigne: Mit einer Verkaufsbilanz von mehr als 30 Millionen Alben ist die Sängerin eine Lichtgestalt unter ... ~http 	positive
Nabend Ladys ^^ und die wenigen Herren... die es gibt ^^	positive
so nun meld ich mcih auch mal wieder zu Wort :D bin zur Zeit leider auch etwas ausgelastet; so das ich kaum zum schreiben komme ^^	positive
In der #Elfenbeinküste verbrennen #Studierende ihre #Studentenausweise; um nicht Ouattaras Rebellen zum Opfer zu fallen. @user @user @user	neutral
So; habe jetzt genug von den Schein-Knieschmerzen. Gehe mir jetzt gepflegt einen oder zwei oder... Glühwein trinken...	na
Dieses Video musst du dir ansehen! -- grabovoi-youtube-part1.m4v ~http	positive
Sieg in Paderborn ~http 	positive
"Wat de ""Loulou"" Schiltz kann; dat kann den Halsdorf scho laang. Och heen waert viru Geriicht géint de Colonel Ries verleieren."	na
Nicht vergessen: Heute nachfastnachtliche Keller-Erstürmung ab 19.00 Uhr!	neutral
Bereits heute beginnt die Anreise zum Drachenfest nach Artlenburg. Wir sehen uns auf der Drachenwiese!!!	positive
Die Blöden haben die Weltherrschaft übernommen; und wir sind schon in der Minderheit. Wolfgang Trepper ~http 	negative
#FF Sollte in keiner Timeline fehlen: @user mit lieben Grüßen aus Dubai!	neutral
Morgen oder übermorgen bekomme ich den 32 Zoll Fernseher und ein Sony Heimkino System :)	positive
Noch eine Stunde; dann Schluss : D	positive
Gerade Update auf 2.2.1 für mein Samsung Galaxy..und immer noch ein Geniales Telefon wer brauch da schon Apple..:-))	positive
#kastagnettenkurs war mal wieder super - danke an alle Teilnehmerinnen.	positive
Video: Das sicherste Fahrradschloss der Welt Eine verrückte Technik-Idee; die nicht nur Fahrraddiebe zum... ~http	positive
"ich rede mit einer freundin über brüste und sie schickt mir plötzlich ""wonderful life"" von hurts - sie hat's erfasst!"	neutral
werd ich morgen im stande sein früh aufzustehn ??? je ne sais pas !!!!!	neutral
Wellness am Freitag und LuuBooks für Intellektuelle; Intelligente sowieso; Sammler inklusive and Highspeed-Leser ~http 	neutral
der Weg nach Hause mit d. Bennek Bus dauerte 12 Stunden lang. Bei abstellen der Köffers sank mein man; und hat einen Slaganfall erlitten.	negative
"Man merkt dass Microsoft hinter ""office: mac"" steckt. Die Installation dauert ewig und 3 Tage !"	negative
Demonstrant mit fremdenfeindlichen Parolen auf der Uni-Brücke.  #Rub #Bochum ~http 	neutral
Eon-Chef verzichtet auf Vortragsfolien - sonst müsste er sie womöglich sogar noch veröffentlichen. #Ethik #fail	negative
Der Nikolaus war auch auf dem Kapellenhof und drehte mit den Kids sogar ein paar Runden auf seinem Schlitten! ~http 	positive
Hallo ihr Lieben!  Das Kontaktformular für die Grußkarten ist online! Es darf sehr gerne benutzt werden :)  Die... ~http 	neutral
Also immer nur eine Verlinkung auf eigene Seiten finde ich auch nicht so superspannend... oder man nimmt es hier nur als #Trafficbringer	negative
noch voll gestopft von gestern... :-O mit mamas weihnachtsgeschenk spielen :P Nintendo DS :)	positive
Ich bin bald durch mit Arbeiten. Nur noch ein paar Tage. Leben; ich komme! &lt;3. (Gute Nacht; Welt. Ich hab Frühschicht!)	positive
Ich hab KP; was ich schreiben soll...	neutral
"Ich dachte .. wir ... waeren Freunde! ""Freunde? Alter.. Nur weil ich dich genagelt hab; bin ich nicht dein Freund; Jesus!"""	neutral
Zurück in Curacao :)	positive
#ff @user @user @user @user  Schönes Wochenende euch allen	positive
"Dieses Video musst du dir ansehen! -- Manfred Kriegel; (THE PANHANDLERS) Cover ""POOR BOY"" (THE LORDS).MPG ~http  via @user"	neutral
es gibt Lieferengpässe für die neue Sony Vaio F-Serie Notebooks. Na ich warte dann wohl noch etwas; aber lasst mir bitte eins übrig ja? :D	neutral
Meine Oma ist echt zu hart. Streut Cheyenne-Pfeffer über die Chips und stellt sie dann den Jungs heimlich wieder auf den Tisch.	neutral
fragt sich gerade; wie man es ohne Samsung #Galaxy S i9000 aushalten konnte.	positive
Na wer hat denn bei Sony die ganzen persönlichen Daten geklaut?Geohot? Wie gut das ich ne Wii hab.Alle mit Bankdaten kontroll.eure Auszüge!	neutral
flyer im druck!  30.01 mit disco soul; funk von jenndy&hong; indieclash von philipp&claudia's discoinferno; detroit techno by brinker. yeah!	neutral
Neues Event: ~http 	neutral
Geld-Rot finde ich ganz schön hart... #fcb	negative
Zukünftiger Samsung Galaxy Besitzer vom Nebentisch hat endlich das Lokal verlassen. Selten soviel Schwachsinn (mitan)gehört.	negative
Ich habe gerade einen anderen Blog eröffnet: ~http  Keine anderen Fotos ... aber mir gefällt das Styling mehr	positive
der sommer ist die eindeutig bessere jahredzeit!	positive
Feierabend und Sonnenschein - so wünsch ich mir das! Na hoffentlich haben die Jungs und Mädels bei Rock am Ring auch soviel Glück! #rar	positive
Aus religiösen Gründen - Stewardessen müssen zum Busen-Test ~http	neutral
"SMS schreiben; mit so einem sog. ""nicht iPhone"" ist ganz schön schwierig"	negative
ich kauf diiiiiiiiiir gucci und pradaaaaaa #SVVAG	neutral
Erdbeben in Köln?! Sorry; das war ich! Hatte die glorreiche Idee mal wieder Laufen zu gehen...	negative
Schmadtke als Sportdirektor; mmh. Aber warum sollte der H96 für unseren Chaosklub verlassen... #effzeh	neutral
Das perfekte Geschäft   ►► VİDEO  ~http 	positive
Chinesische Weisheiten: Ein reines Herz lässt die Schönheit einer Frau wachsen ~http  via @user - Oh wie wahr!	positive
Ich habe @user gerade 6mal gefavt. &lt;3	positive
die Bild hat schon das Sommerloch entdeckt...so bereiten sie sich auf einen Zombie Angriff vor	neutral
"Noch mehr Fliegeransichten bei Panoramio? ~http  Viel Freude beim ""Sessel-Fliegen"" und Träumen..."	neutral
Hab gerade Werbung für den App store in einem #Android app gesehen :-D #fail	neutral
#Holzwickede Haushaltsberatungen: Hälfte der Sparvorschläge gar nicht realisierbar: Seit Anfang der Woche sitzen... ~http 	neutral
Ich mag ein YouTube-Video. -- Der neue Audi A6 - Nachfolger mit geschärftem Charakter ~http 	neutral
alles muss raus!!!! piercingschmuck 50%	neutral
schon ein Bier macht mich depressiv. jawoll!	negative
"Oh man; unser Besuch weiß nicht was ein ""Hackenporsche"" ist"	negative
Comment on NRW: Erdbeben der Stärke 4;4 by Michael: Hm… In Nettetal nichts davon gemerkt. Vielleicht war ich auc... ~http 	neutral
M4 am 22. Mai 2011 LIVE in Pirmasens ! TREFFT DIE JUNGS PERSÖNLICH ! EINTRITT FREI ! ~http 	neutral
Ein weiterer kulinarischer Höhepunkt! ~http 	positive
Schön war´s - Jahresempfang des Wirtschaftsforums #Hersbruck - die #Werbegemeinschaft lebt! ~http 	neutral
Und wir machen uns knackig (@ McFit Bonnerstr) ~http	neutral
Marduk is der Stadtgott babylons Wusst ich garnich :D	neutral
Paris Hilton kommt am 3.2. nach frankfurt...wer nimmt mich mit dorthin ?^^	neutral
Ich liebe @user. Aber leider bin ich nur einer unter Milliarden. :(	negative
Ich glaube das maedl will mich veralbern	negative
WahlRECHT; liebe Leute. Nicht WahlPFLICHT. Das ist ein Geschenk; keine chronische Krankheit. #Wahlmuffel	positive
Nettes Tool für #Socialmedia - über welche Plattform erreiche ich welchen Kunden? ~http 	neutral
Kurioses Plugin: Das Bild hängt schief. ~http 	neutral
Neu @ Kingbonus Samsung S8500 wave Gewinnspiel ~http  #geld #sparen	neutral
Ich weiß; warum alle Welt MonCherie einpackt und verschenkt: Fragt man die Leute nämlich höflich; nehmen sie's nicht!	neutral
#S21 #Stresstest Nahverkehr im Filstal oft nur 30 Sekunden geplante Haltezeit --&gt; Verspätungen einprogrammiert	negative
Hhm; lecker! - Rezepte; die Kindern wirklich schmecken - von Karolina Sparring et al. - Thorbecke. ~http 	positive
Endlich: Die Nike Sneaker aus „Zurück in die Zukunft“ sind da! [Bildergalerie; Videos]: Turnschuh-Fan? „Zurück i... ~http	positive
ich glaubs ja gar net; die paracetamol hat echt was gebracht... O.o dann geh ich jetzt schlafen! gut nacht... =)	positive
Nichts zu tun... Vielleicht sollte ich mal was für die Schule machen?! Wäre wohl nicht schlecht =D Mal schauen...	positive
I liked a @user video ~http  Die Sendung mit der Maus - Liebe	neutral
ins Bild -.- In einem Monat bekomme ich warscheinlich Sony Vegas Pro *_*  Achja und weil es grade speichert hängt das Internet total	neutral
Hat sich eigentlich schon mal einer von Euch gefragt; warum @user sein Handtuch nicht mehr vom Kopf nimmt? Bad feather day?	neutral
Das war mal nen anstrengender Tag! Aber morgen ist ja Wochenende. Problem nur; das ich da auch volles Program habe.	na
ich grab einen geheimen tunnel von mir zu meiner herzdame...x]	neutral
Boah gerad beim rasieren aftershave ins Auge bekommen - echt fies wie das brennt. Nunja dafür is die Kontaktlinse wieder lupenrein :-D	na
Schmiere mir gerade Haarfarbe auf die Ohren. D:	negative
Ich mag ein YouTube-Video. -- Die Ärzte - Geisterhaus mit Text ~http	positive
Ooh danke Fussballgott; Iniesta und Paul..Spanien ist Weltmeister!!! :D	positive
Getade aufgestanden...mal sehen ob wir essen bekommen x.x	neutral
Navigationen ausblenden im #PHPKIT 1.6.5 leicht gemacht. Mehr Infos: ~http 	neutral
Pro7 & Sat1: Unterhaltung trotz Feuer ~http	neutral
Ich hab jetzt nur noch meine gefürchtete Physikklausur vor mir. Gott segne mich. XD	neutral
Kochidee des Tages: Selbstgemachte Bandnudeln in Mehlschwitze - ganz einfach; ganz lecker! ~http 	positive
Oh Gott. Ich muss jetzt was essen.	negative
Eines meiner Lieblingsrestaurants ist verschwunden -- inklusive dem gesamten Gebäudeblock...	negative
Wieso sieht Google heute eigentlich aus wie Bing? Haben die tatsächlich endlich Microsoft gekauft?	neutral
Man man man; den Job von der Eichinger kann ich auch noch machen; blablabla...#dsds	negative
"Quäle mich gerade durch ""Blut & Barolo"" ... Leseprobe gefiel mir; aber irgendwie kann ich jetzt mit den tierischen Helden nix mehr anfangen."	negative
Ist es nur freundschaft oder doch mehr? Ich weiß es nicht!! Ich bin da; wenn du mich brauchst.Ich glaub ich bin unglücklich verliebt :/	na
Also diese Sarah Engels ist mir absolut unsymphatisch! Also der würde ich kein Meter trauen #DSDS	negative
So; heute mal etwas früher ins Bett. Morgen Besprechung; möglichst ohne große Müdigkeit über die Runden bringen...	neutral
Für Gewinner: ~http  Pokal aus Kristallglas! ~http 	neutral
I hate this Sony nonsense! „Dieses Video enthält Content von Sony Music Entertainment und APM. Es ist in deinem Land nicht mehr verfügbar.“	negative
Kein Spiellicht in der O2 World. Seit 30 Minuten Drittelpause. #ebb #fail	neutral
Reiche fordern Reichensteuer; aber erst NACHDEM sie ihre Koffer in die Schweiz gebracht haben. Ihr wisst schon: Urlaub (zwinkerzwinker)	neutral
Schlafen. Morgen Berufsschule; dann zu Angie :3	neutral
Dort lebt er mit seiner Mutter und seinen zuckersüßen Geschwistern „Snickers“; „Bounty“ und „Toffy“. Es geht um Twixx!!	neutral
Die buehne fuer heute abend :)  ~http 	neutral
Die Fußballmädels sind zwar draußen. Aber die hier kickt einfach unbeirrt weiter. Und zu haben is‘ sie auch noch: ~http 	neutral
lächerlich	negative
sitzt auf ihrem Garagendach und genießt SN die 3 te :)	positive
Ich empfehle: DER FLIX - Heldentage 2.0 vom 24.02.2010 ~http	positive
Ach; der neue 3DS-Preis erhöht nartürlich denn Druck auf Sony und so ^_^'	neutral
um viertel vor 11 wieder 1 1/2 std fahrstunde xx hoffentlich kann ichs noch xD haha	neutral
Und der Jung ist erst 19; so neben bei ;) RT @user Alter Falter! RT @user Das Tor war so hammer ~http 	neutral
Bei SONY waren selbst die Hacker von dem Sicherheitstandard der keiner ist entäuscht... ~http  #security #Hack	neutral
achja hab das neue essence und p2 sortiment gefunden *o* wuhuuu xD	positive
Wir können ja einen offenen Brief an die CDU schreiben; auf dass die Sorgen verbieten. Ich wäre dafür. @user	neutral
#Killerspiele #verbot #gez #bürgerrecht #zensur ~http  #piraten+ #cdu- #spd- #btw09 #spiele	neutral
Ich bin morgen weg; höhö.. Ich schreibs dir dann ^^ @user	neutral
ENDLICH... ab 23. Dezember im Kino: ~http  #tintin #spielberg	positive
Sagte gestern ein Typ zu mir:'Mensch; ohne Jogginghose hätte ich dich ja fast gar nicht erkannt.Du kannst ja richtig chic aussehen!'-Spasti!	negative
Das schöne an Hausverbot in der #bgs: Man kann sie aussprechen ohne dass man das Schiedsgericht oder Ordnungsmaßn. braucht. (cc @user)	positive
Nintendo will keine “Garagen Entwickler”-Spiele auf Nintendo Geräten ~http 	neutral
Ich hab nen Pott voll grüne Bohnensuppe gekocht; wer was will möge bitte mit einem Tellerchen vorbeikommen. Gez: Der Suppenkasper	neutral
Nicht toll; nach Sony wurde nun auch BioWare gehackt.  ~http  @user @user @user	negative
Brilliante Eikommensmöglichkeit 1/5 ►► VİDEO  ~http 	neutral
"Lt Synonymwörterbuch sagt man auch ""bemannt""/""beweibt"". Ok; muss ja nicht alles nach 7.Himmel klingen; das aber klingt nach Zuchtstation Ó;ò"	negative
ist schon seit einer Woche MCTS: Microsoft Office SharePoint Server 2007 - Configuration (2009) ; gibt damit aber nicht so an ;-)	neutral
i'v a stomachache.	neutral
Ich gehe jetzt schlafen und ja; ich weiß; dass es Freitag ist :/ Aber ich bin so kaputt! Gute Nacht euch allen später &lt;3	neutral
Ganz feines Video: RT @user hot chip hot chip hot chip - es ist so geil! ~http 	positive
Jetzt werden marci und ich schon per Handschlag beim döner begrüßt. Wir sind halt zwei stadtbekannte Größen!	neutral
Da sitzen die profimuetter mit ihren gucci taschen und den teuren kindern #angekommen #hamburg #rothenbaum :)	neutral
Apple und Microsoft erwägen Bündnis gegen Google  ~http 	neutral
pff; wer braucht schon liebe oder schlaf ?!	negative
in dr Stadt.|will nach Hause :D	neutral
Die ersten Menschen beschweren sich schon das meine ICQ nummer kapput ist! Nein ist sie nicht das muss so!	neutral
ja ok dann sag ich ma Neu &gt;&gt; microsoft veröffentlicht windows update - zweck dieses update ist unbekannt (cont) ~http 	neutral
macht Facebook heute auch noch was anderes außer #Fails anzeigen //mg	negative
Neues Lieblingsvideo gefunden! :-) ~http 	positive
"Heinz Strunk (""In Afrika"") ist sehr komisch; aber auch absolut ohne Mitleid. Das scheint zusammen zu gehören."	neutral
Ich empfehle: Dodge & Burn ~http 	positive
euer bester freund	neutral
Heute #Worldcup! Leider noch ohne #ger dafür aber schon mit #fra! Das wird noch ein spannender Abend heute!	positive
"Mankiw (Buch S. 5): ""Wenn die Regierung den ökonomischen Kuchen in gleichmäßigere Stücke schneidet; wird der ganze Kuchen kleiner!"""	neutral
"In Europa gibts ja schon schwarze Pisten; in Kanada ""double black diamonds""; und das wo die Ösis sonst das Skigebiet sperren würden! Rules!"	positive
Guten morgen 	positive
Lw ;P | Wer Will Verheiratet Oder Soo Haben ? ; Nachricht Schreiben  «3	neutral
kommen gerade vom Plastic Bomb Radio Interview... danke an Sven und  Vasko... Ausstrahlung ist am 17. November... natürlich live!	neutral
Ich will ein Asteroid von Parrot bei @user gewinnen #gizmodoDE	neutral
Wow! Duisburg ist doch nicht so tot; wie es manchmal tut!! Vielen Dank an alle Anwesenden; war ja mal wirklich... ~http 	positive
Bear grylls ist der einzig wahre MacGyver	neutral
Sie findet kein Ende! (@ Bazaar) ~http 	neutral
Ich will diese Liste hier gewinnen: ~http  #tweetpaketverlosung #tweetpaket	neutral
Bio hab ich mir jetzt regelrecht reingedroschen. :D Völlig überfordert und im Stress; aber trotzdem glücklich .. irgendwie. :&gt;	positive
Unser heutiger Stargast! :-) ~http	positive
Rip Puckelpop opfer :/	negative
Salz für die Nase &lt;3	positive
Die Bläser der Big Band; die noch keinen Ständer haben; sollen nach oben gehen und sich einen runterholen	neutral
SCHICK!! RT @user Samsung Galaxy Tab 10.1 Unboxing und Vergleich mit iPad 2; TouchPad; Iconia Tab und Eee Pad… ~http 	neutral
Samstagmittag der Schädel brummt; die Lunge pfeift!	negative
scheeiße :D ich will aber ! x'D	negative
Das perfekte X-mas Geschenk! ~http 	positive
wuhaaaaaahaaaaaaaaaaaaaa; wer hätte gedacht; dass ich auch bei twitter angemeldet bin ^^	neutral
Sämtliche Apps vom Ipod gelöscht um Platz für das Wichtigste zu machen: MUSIK; dafür hab ich das Teil schließlich. Tschüss Angry Birds & Co	neutral
schönes Wochenende dann noch! Was??	neutral
sooo müde &gt;3&lt; gute Nacht!	neutral
"Vorhin heiße Zitrone getrunken und gedacht: ""Woran erinnert dich das nur?!"" Nun Fällt's mit ein. TEQUILA 8D"	neutral
Gefahr fuer freie Medien in Ungarn; ~http  #wienerzeitung	neutral
"Zitat @user : ""Biep! Crckz! Ratter-Ratter! Mehmep! Wiisssssd!... Was denn; ich bin ein Drucker!"""	neutral
Das Hamsterrad laeuft und laeuft und und laeuft und laeuft und laeuft und und laeuft...  Ich lauf mit.	neutral
" Du liebst mich nich; du willst nur sex! D': -"" MAMA!"""	negative
Hör dir Jennifer Lopez Feat. Pitbull von On The Floor an! Ich habe den Song gerade mit TrackID™ von Sony Ericsson gefunden.	neutral
kann man ne ausbildung zum profi messy machen ?=?	neutral
Lustig zu sehen; dass Microsoft dort angekommen ist wo Apple vor ca. 3 Jahren war - mit iOS 1.0 ;) ~http	neutral
Boah @user und @user stinken mal wieder heftig aus dem maul.. Am verwesen?	negative
So n Mist; warum ist der Akku vom #G1 immer leer	negative
mit conny mandalay ;)	positive
Ich habe ein YouTube-Video zu meinen Favoriten hinzugefügt. -- Jennifer Rostock - Paris ~http	neutral
Facebook Busted in Clumsy Smear on Google ~http  via Spiegel Online	neutral
Twitter hängt und hat wohl mit technischen Problemen zu kämpfen???!!! ich kann meine nachricht nicht posten!!!!!	negative
Ich mag ein YouTube-Video. -- Glücksbärchis Theme ~http 	positive
Masse statt Klasse? Folgt man z.B. @user wirds schon unübersichtlich. Masse und Klasse wäre gut...	negative
234 Fans? und Nike hat mehr? Das geht doch nicht! Liket mal schön ... für #FAIRTRADE ~http	negative
wieder zuahuse.. xD war doch ganz schön ;) .. gleich mal schnell duschen dann gucken was geht (:	positive
Zugeschneiter Eingang uzu den Ferienwohnungen ~http 	neutral
Letztes Mal #Frauentausch war lustiger. Diesmal ist es ziemlich lahm.	negative
guten morgen ihr Verrückten	positive
Die ^-Taste sollte zu ^^ umfunktioniert werden. Einzeln braucht man das Ding doch sowieso nicht ^^ ( &lt;-- Siehst du?  Zwei! )	positive
So ich verlasse euch bis sonntag hab euch lieeb :*	positive
Träumen von warmen Eislutschern: ~http	neutral
Hundi liebt Fußball! Was für ein Glück; dass ich zz nicht werfen darf; sonst hätten wir diesen Spaßt nicht für uns entdeckt! #Ridgeback	positive
Faster! Seit langem mal wieder ein Action Film der richtig gut anzuschauen ist.	positive
Zu einen dieser ominösen Abstürtze ist es nicht gekommen! =)	neutral
Windows 7 Deployment Wettbewerb - nehme teil und gewinne exklusiv eine Reise zu Microsoft nach Redmond - ~http 	neutral
Grad lange mit @user in der #lateline geredet. Und dank seiner ReTweets gleich wieder was gelernt.	positive
9 von 10 Stimmen in meinem Kopf sagen ich bin nicht verrückt! Die andere summt die Melodie von Tetris...	neutral
Endlich gute Live-Bands für die kommende Festival-Saison? ~http	positive
Wichteln twittern!!!: Also Ihr Menschen habt schon dolle Techniken. Wir haben jetzt Twitter entdeckt. Zwar mach.. ~http	neutral
Ich werde jetzt noch ein paar Zeilchen schreiben und dann hochladen; yöööööy. Unbetagelesen; weil Nacht ist und weil ich cool bin.	positive
Viel versprechende #effzeh Zugängen bis jetzt; nur noch Hajnal fehlt mir.Nur mal so;der gescholtene Meier war schon sehr weit mit d. Spieler	positive
Die sonne nervt :D	negative
Verfassungsbeschwerde gegen Websperren-Gesetz ~http 	neutral
Düp düp düp noch 10 minuten :)	positive
Uh danke Facebook. Endlich haben die Leute den alten Chat wieder. Und das Geweine ist zu Ende.	positive
Betrachte verstohlen die Kollegin. Die hat sich eindeutig hochgeschlafen. Ganz allein; vorm Bildschirm lümmelnd.	neutral
Sinnvolllos.	neutral
Wieso macht Nintendo Werbung fuer goldeneye mit Grafik aus der Steinzeit ?	negative
heute is i-wie ein beschissener tag.. .. ... (jaa.. ich weiß ich verbreite wieder nur schlechte laune.. dankeeeee... xD xD)	negative
Qualifizierung wird zum Live-Erlebnis auf der CeBIT 2011! Die Bundesagentur für Arbeit präsentiert sich interessant! ~http 	neutral
"Sie braucht für mich den ""Alle Foren immer als gelesen markieren""-Button."	neutral
Zurück von der #fusion - Gesund und glücklich; aber nass!	neutral
Eis essen; Zähne putzen und ab ins Bett. :D	neutral
das aber n tolles Video! ~http  :-)	positive
Auf großer Oster-Mission für Sony unterwegs. Als Belohnung warten tolle Preise auf mich: ~http 	neutral
Ehrlichkeit is ein teures Geschenk; dass man von billigen Menschen nicht erwarten kann.	neutral
schön war es wieder mal bekannte gesichter aus den ersten wochen zu sehen. trotzdem - Det. 8. April ;D	positive
..omG..wiee soLL ich 1 Wochee ohne GzsZ übersteHen :(	negative
Yey; gestern war fett (: || Auch Wenn Mir 20 Euro fehlen.	positive
hat grad glückskekse gebacken.	neutral
Has ma Kleingeld? WAS? SEH ICH AUS WIE FRAU HOLLE ODER WAT???	negative
Heute: Erste-Hilfe-Kurs. Yay.	neutral
ich suche noch immer nach einer erklärung; warum die feuerwehr aus #gengenbach nachts um 5 uhr mit martinshorn fahren muss. ideen?	negative
"Wir ""rennen"" jetzt auf die Microsoft Standparty :) Aber vorher noch Franzis Wrap Up vom #CeBIT Tag 3.... ~http "	neutral
Und wenn es das letzte ist was ich tue...	neutral
Awesome - nach 8 h Dauernutzung meines Samsung Wave ist das Akku immernoch halbvoll #gsda	positive
Wir wünschen ein schönes Paderborner Schützenfest	positive
Rooney-Kopfball-Tor nach Haartransplantation belegt: Er ist der schlaueste Fußballer der Welt (Kopf nicht nur zum Haareschneiden).	neutral
"Read my response to ""Jahresurlaub; lange darauf gespart. Und dann kommt Murphy um die Ecke und du stellst fest das…"": ~http "	neutral
Ich wünschte wirklich; es würde weniger Wind wehen. #Hamburg an einem #Sonntag im #Sommer	negative
Harry Potter zu Ende .. kann ich mir nicht vorstellen	neutral
Bisher größte Krachmachergruppen: Lebenshilfewerk Mölln-Hagenow (100 Krachmacher) und Lebenshilfewerk Pinneberg (70 Krachmacher)!!!	neutral
halli hallo ich schreibe gerade meinen ersten twitter eintrag ueber meinen nintendo ds mal schauen ob es funktionirt	neutral
Yay! Das neue Eden in Neunkirchen arbeitet ab 28.01 mit Digital 3D :-)	neutral
Moin Moin heute ist bergfest. Noch 2 mal schlafen dann wird das wochenende eingeleutet	positive
Eine Packung Nerdwitze: ~http  (@monkeydom @user)	neutral
Hitler-Bier laut Bild geschmacklos. Ich finde man hätte es aus Protest gar nicht erst trinken sollen.	neutral
Für Freunde von Sony Kameras und Camcorder und die; die es noch werden wollen: Alle Sony Produkte in einer Welt: ~http	neutral
Am 7. Tage sollst du ruhen- nur welcher ist der 7. Tag im #Twitterland ? Allen ein wenig Ruhe in dieser hektischen Zeit !	neutral
Lust auf Tomaten und Gurken? Gemüse Insel Reichenau!!  PS: Hoftl. Ist bald der Virus tot !!!	na
Bitte sag; dass die weißen Flocken auf dem Mantel meines Kollegen Schuppen sind	neutral
Mit Interesse verfolgen wir die Vorgänge um den Erwerb der Ordensburg Liebstädt. Ein thüringisch-sächsisches Theaterstück ohne Gewinner ...	neutral
frage mich; ob das ergebnis einer bürgerbefragung von wankelmütigen politikern in #lehrte anerkannt wird.	neutral
+49 151 27057180 Was da stalkt jemand @user? haha; der muss sich wohl bald ne neue Nummer zulegen :&gt; +49 151 27057180 RT RT RT	neutral
Durch #Karajan habe ich eigentlich #Klang als Klang schätzen gelernt ; meint #Christian #Thielemann; bald Chef der #Dresdner #Staatskapelle	positive
Beeindruckend; dass immer nur die Politik Kultur kaputtspart; nie jedoch ein Kaputtwirtschaften der Kulturbetreiber in Frage kommen könnte.	negative
er hat seine frau verlasen!! ohh ha o.O	negative
Gizmodo - Microsoft gibt Google Schuld an YouTube-Problemen in Windows Phone 7 - ~http  // selbst schuld wer eins hat :))	neutral
Heute bei Yahoo! Music: Avril lässt sich scheiden. Warum heiraten Celebs überhaupt so früh? ~http 	neutral
Heute das neue Samsung Galaxy i9000 bestellt. IPhone Killer? Vom Display her auf jedem Fall ;)	positive
Dachte eigentlich;dass wäre ein Witz;aber wohl doch nicht: Heute Entscheidung über Wichniarek! Spielmacher wird dringender benötigt! #effzeh	negative
Döp Döp Döp !!! #Gladbach	neutral
!es hat wieder geschneit! :(((	negative
Überlege meine PS3 abzuschaffen? RT @user Sony geht weiter gegen Playstation 3 - Hacker vor: ~http 	neutral
Oh und Bild mitschicken hilft ;)  ~http 	neutral
ich frage mich was an twitter so toll ist...so ein großes mitteilungsbedürfnis habe ich auch net;)	negative
Grosssägerei nach Thüringen; bündner Regierung bezahlt womöglich noch den Umzug; damit's eine runde Summe wird; die man in Sand gesetzt hat!	negative
Ich will wieder Freitag..	negative
Beißt herzhaft Du in Krapfen rein;  sollt Auffangschüssel drunter sein...  #konfitüreauflektüre	neutral
Habe am Wochenende bei der Tante einen Vintage Gucci Weekender abgestaubt! Jetzt müsste man halt nur mal verreisen...	neutral
Für wie blöd haltet ihr uns Hunde eigentlich? ~http  #briard	negative
"Vorhin an der Kinokasse war eine ganze Schulklasse vor mir. Dachte mir nur "" bitte nicht den gleichen Film"". Die waren echt laut."	negative
Ich werd gleich isotonisch.	na
mit @user; @user &'  @user chilln &lt;3 boaa!	positive
Soeben Kräuterbuttergewürz; Hähnchengrillgewürz und Currymischungen in die Nähe von Hamburg; nach Pinneberg verkauft. #KohlsLaedle sagt Dank	neutral
Coole Seite  zum #Tatort: Das Wort zum Mord ~http 	positive
Na bitte; geht doch! Ein wunderschönes Beispiel dafür; wie sich eine negative Botschaft positiv verkaufen lässt.  ~http 	positive
Wie du hast bis drei geschlafen ? :D Ach du scheiße.	negative
"höre einen großartigen Vortrag von Alex Kirlik über ""ethical design"" bei der  ""Usability Professionals 2009"" (UP09)"	positive
Auto abgeben ;-( (@ Audi Zentrum München) ~http	negative
mhh was fang ich jetzt mit dem Wochenende an? Vlt sollte ich mir mal ne Winterjacke kaufen.. Es schneit nämlich -.-'	negative
Sooo;im out :)	neutral
halb zehn in deutschland. verkehrscaos in münchen. als ob die leute noch nie schnee gesehn haben	negative
Steffi Holz: Alltägliche Ungewissheit. Erfahrungen von Frauen in #Abschiebehaft. Literatur bei Unrast: ~http 	neutral
Ab und zu wäre erst ''denken'' und dann handeln besser. Aber man das kann ist die Frage ;D	negative
Allein daheim; allein daheim. Dabei sind meine Eltern und meine Schwester zuhause.	positive
kollegin ist sehr erstaunt darüber; dass sich ptfe nicht wie metall schweißen lässt... ich bin sehr erstaunt über kollegin.	negative
hahahaahaha.. qaiiiil wenn so gut nur unser Fc Köln wäre &lt;3 :D	positive
Bald erwartet mich einen Audi #RS6 Avant. Come On Come On; I like it i like it! :-D	positive
was zum geier ist AIKIDO????	neutral
Verkopft und zugenäht	neutral
Zockt mit @user auf der ganz alten Nintendo voll retro SWAG	positive
"...davon hingegen kann ich nie genug bekommen :) Bild: ""Erster Eindruck: Nintendo beschränkt sich nicht darauf;... ~http "	positive
Ich will ein iPhone 4 32GB bei iPhoneTeam.de gewinnen! Gewinnspiel auf ~http 	neutral
Dass meine Hand perfekt in deine passt; kann doch kein Zufall sein.	positive
Zweifel sind Verräter. Sie rauben uns; was wir gewinnen können.. wenn wir nur einen Versuch wagen würden.	neutral
mein papa hat jetzt 'xoxo' und ich nicht. wusste gar nicht das der sowas hört.	neutral
Nicht Gesund; aber Mitten im Leben: Berlin; Berlin ~http 	neutral
Mir is kalt...	neutral
Stop! nein das kann nicht war sein!	negative
Steuererklärung: check :)	neutral
Guten Morgen Jetlag... ;)	positive
Danke Mainz; weiter so.... #effzeh	neutral
omg meine haare ich seh aus wie alice von twilight...	negative
Du hast Dich zuvor so verhalten; Sozialstellen nicht bemüht … asozialen Händlern anvertraut ... ver-/gebunden fühlend!? Sage Dir; … dann …	neutral
#FollowFriday Eine wandelnde Krise ... und das ist verdammt gut so! ☺ @user | ~http  ☺	positive
isch kle fertig vum training und hockt gechillt vorm netbook #duknb	positive
exrem starke zahnschmerzen. morgn hat mama geburtstag... mist?	negative
Treffen Sie Logwin auf dem 9. Branchenforum Automobil-Logistik am 27.1. im Audi Forum Ingolstadt.Wir freuen uns auf den persönlichen Dialog!	neutral
Ich lebe einen Traum von einem Leben.	positive
In den letzten 24 Stunden ist die welt nicht untergegangen; ich bin erstaunt. Oder habe ich es einfach verpasst?	positive
Kondome-gratis.de startet neu.Als kleines Neujahresgeschenk erhälst du bei uns 6 vollkommen kostenlose Kondome! ~http 	neutral
Kopfhörer auf- Musik an- Welt aus!	positive
Glutenfrei backen: über 80 Rezepte für überragenden Genuss - von A. Kirchmaier et al. - Umschau Buchverlag. ~http 	neutral
Ein Programm das mir das telephonieren und das internet abdreht wenn ich es verbraucht habe.  Ja praktische sachen giebts nur am hTc.	neutral
Auch ein Sieg für die Fairness. Vettel Weltmeister! #stahlregie #f1	positive
Die Müllabfuhr rettet meinen Tag!! Einfach zu göttlich; dieser Krüppelmann =D Beschwert sich bei uns über die Mülltrennung o.O.	positive
Soeben ist der heutige Kreuzfahrt-Newsletter verschickt worden. Ihr wollt die Themen des Tages kennen? Meldet euch an! ~http 	neutral
Nike; Adidas & Co. verzichten auf Chemie in den Klamotten? Ja; das wär fein! Neue #Greenpeace-Kampagne setzt Zeichen: ~http	positive
Schwarz Gelb lässt die Hosen runter: ~http  Wie weiter? ~http 	neutral
Duderstädter frühlingsfest. Gleich feuerwerk... ~http	neutral
"Da brennt in #Schwalmstadt ein Gymnasium ab und niemand titelt ""Hurra Hurra die #Schule brennt"" - FEIGLINGE!"	neutral
bei der Form geb ich auch der Microsoft 6000 den Vorzug.Den Kurs mit den Handschmeichlern müssen die Logitech Designer verpasst haben	negative
Hab mich gerade mit einem unterhalten; der von sich meinte er wäre ein Junkie. Dabei kennt er nichtmal den #hashtag.	neutral
hab mich achtzig Mal verdrückt; aber Schatz; ich schrieb zurück.	neutral
Eines Tages schwimmt die Wahrheit doch nach oben. Als Wasserleiche. (Wieslaw Brudzinski)	neutral
#Grundrechte schützen! Schäubles Überwachungswahn #Monitor #Sendung vom 12.04.2007 ~http  #piraten+ #cdu- #btw09	neutral
Ich komm nicht weiter #mariobros ärgerliche unterwasserwelt aber einfach ein geniales Spiel	positive
Spinne in meinem Zimmer getötet &gt;.&lt;	neutral
Auch in Düsseldorf kommt Samstags also der Schrottsammler :D	neutral
Was ist das?? Fc manner schnitte oder was? :) ~http 	neutral
Mein Chef ist so vergesslich; dass ich ihn daran erinnern muss; dass ich ihm erinnerungszettel geschrieben habe.	neutral
Köstliche Rezepte aus aller Welt (Sachbuch) - von Roberto Mottadelli et al. ~http 	neutral
Das Wetter könnte nicht schöner sein!:(	positive
so zwischen schlafen und koma schloma	neutral
Das ist für Ghana echt bitter!	negative
Uneingeladene gaeste bei einer party sind echt assi; vor allem wenn sich dabei um die #polizei handelt! #rockon	negative
noch die letzten highlights vom samstag anschaun. (watching Schlag den Raab via @user) ~http 	neutral
Heimatgefühle ~http  #briard	positive
"Mit großer Verspätung ""Feuchtgebiete"" gelesen. Fazit: Kann man sich sparen...passend hierzu: ~http "	negative
vielen dank.klarer sieg für gucci ;D	positive
Gestern Ridley Scotts Robin Hood von 2010 gesehen. Zweieinhalb Stunden verschwendete Zeit....langatmig und unnötig.	negative
Wie geil RT @user Samsung lässt Galaxy-Tab-Displays künftig auf Rückseite montieren ~http 	neutral
Hör dir Taio Cruz von Higher an! Ich habe den Song gerade mit TrackID™ von Sony Ericsson gefunden.	neutral
Hört mal bei Dead United rein... oder besucht gleich ihr Konzert. passende News dazu: ~http 	positive
Huhu :) Nicht so oft online; habe viel um die Ohren...	neutral
Opera mini ist ja mal genial fürs surfen mit GPRS / Edge auf dem iPhone.	positive
Dieses Video musst du dir ansehen! -- Paris Hilton sexy spot Go Yellow ~http 	positive
Dieses Video enthält Content von Sony Music Entertainment. Es ist in deinem Land nicht verfügbar.  FUUUUCCCKKK OFFFFF!!!!!!111	negative
Liebe KandidatInnen der @user Konsumentencharta - Einstehen für die Konsumenten! Danke! ~http  @user	neutral
KONZ Steuertipps gibt auch Tipps und macht Verlosungen auf Facebook - Wir freuen uns über 46 Fans!	positive
"Gerade hat sich ein junger Mann aus dem Newsletter abgemeldet. Begründung: ""habe meine grosse Liebe jetzt... ~http "	neutral
Halber Arbeitstag vorbei...endlich Pause	positive
Aufbau eines DEUTSCH-AFRIKANISCHEN Verteidigungsbündnis zur BEFREIUNG der Welt. Es wird immer besser hahaha	negative
Planung des irischen abends angenommen. gleich mal nen Irish pup gegründet. er trägt den Namen:  Irischer  PAP	neutral
Gruppensport ist Massenmord.  Heute zwei verletzte beim Fußballspielen. Einer davon jetzt im Krankenhaus.	neutral
juhu jetzt fuintz der transfer ned un d ich hock am rechern -.- endlich daheim	na
Das Bing Hintergrundbild ist klasse aber längst nicht so imposant wie darunter zu stehen.	positive
Gleich ist Zapfenstreich im Hostel. Kiddies haben sich morgen ausschlafen vor dem Event verdient. #LostInMV	neutral
muss sich nun 2 Stunden mit so mittel Metalbands die Zeit bis Peter Fox vertreiben	negative
faul sein ._.	negative
Jetzt weiß ich wieder warum das #Traumschiff nur 3x/Jahr läuft: es könnten die Ideen ausgehn.vorteil: die leut könnten vergessen was kommt	neutral
Morgen beginnt mein erster Tag an der Fh :-) und so ziemlich meine letzte Woche bei meinem Arbeitgeber!	positive
Ich habe ein YouTube-Video zu meinen Favoriten hinzugefügt. -- Disneys König der Löwen... ~http 	neutral
im regen ins kino - keine gute idee	negative
Morgen noch treffen mit Chef; dann WOCHENENDE; mein erster freier Samstag seit September....fein fein fein	positive
Insb. auch empfehlenswerte Restaurants oder Läden. Nicht das was in jedem Reiseführer steht.	neutral
Ein kräftiger Schienbeinmuskel verleiht Fußgelenken beim Laufen mehr Flexibilität & Stabilität. 1a Trainingsgeräte: Balance Pad & Bosu Ball.	neutral
Kämpfen und Siegen #SGE	neutral
Und der Moment; in dem man beschließt; nicht alles ergründen zu wollen um seinen Frieden zu finden; .. wird den Frieden bringen.	positive
OMG!!!!!!!!!......#SexRobstenBR	neutral
Hach #Sommer. Wir hätten dieses Jahr so gute Freunde werden können. Aber du hast mich ja sitzen lassen....	negative
Weiter geht es mit: #ff @user @user @user @user @user @user @user @user	neutral
Auf großer Oster-Mission für Sony unterwegs. Als Belohnung warten tolle Preise auf mich: ~http 	positive
ok mir ist sehr langweilig. house of night lesen und so :D	na
Wenn Zeit ist werde ich heute einen eBook-Reader von Sony mal testen ( beruflich natürlich)	neutral
Sendung ist seid 4:37 in Köln; kann ich ja fast selbst abholen :-)	neutral
SALAFISTEN;trojanisches Pferd des Terrors?Alle islamistischen Terroristen waren Salafisten..züchten wir den Feind in unsrem Bett?	neutral
was macht eine betrunkene blumenverkäuferin? fleder-floristik! #alkohol #spaß #epic	neutral
Unfassbar: Britney Tickets für 2;30 Euro! ~http 	neutral
[DiscoSion] Vielen Dank für verfolgen! Ich hoffe euch bei unserer Veranstaltung im Namen der Iniziatoren begrüßen zu konnen VG @user ...	positive
Ich: gehe gleich in deinen Spülkasten kacken wenn du nicht aufhörst zu nerven! Er: OKAY! :D	negative
"#Preisklagemauer - Abzocke des Tages: Fischfutter TETRA ""XL-Flocken""; 1000ml; Preisaufschlag 257% ~http "	neutral
R.I.P Ryan Dunn!  so oft dem tod ausgewichen und jetzt ein autounfall #finaldestination #fb	neutral
und schon hab ich kein bock mehr auf spanisch; todo lo que apesta	negative
neben rtl für die schwiegertöchter möchte ich auch manchmal rtl2 für frauentausch danken... DANKE!	positive
Mittwoch *-*	neutral
INNOVATION - Nintendo küntigt 3D-Mobilkonsole an; die keine 3D-Brille benötigt! ~http 	neutral
F***k!!! Leider kein #rydercup in Deutschland ;-( Frankreich...	negative
Sag nicht: Ich kann das nicht. Sag: Ich kann das noch (!) nicht.	neutral
Antrag beim BVA übers Internet gestellt; Bestätigung kommt per Briefpost (klar; gut so) - mit drangetackertem Folgeantragsblankoformular...	neutral
War ja klar. Behörden verbieten #Protest gegen #Papst ~http	negative
Hab limit -.-'	negative
Wochen? Monate?-Lang nichts getwittert und immer noch follower unglaublich	positive
"Lesenswerte Anregungen: RT @user ""Luft beim Atmen"" - ~http  - aus #Grundelemente; einer neuen Seite der Lyrikscheune"	neutral
Gangstar: Miami Vindication HD absofort für 0;79€ statt 5;49€ im AppStore zu finden ~http 	neutral
Keinohrnazis LOL #TvTotal	positive
Das Projekt des Jahrhunderts startet bei trnd - gesucht werden 40 Onlinereporter fuer das XPERIA X10 von Sony Ericsson - PHAENOMENAL!	neutral
Und damit parkte Herr Dachs bei Frau Hecht ein und sie schliefen ein.	neutral
#Greenpeace: Adidas will auf giftige #Chemikalien verzichten ~http	neutral
findet es super das es schneit #schneeflocken_mit_mund_fang	positive
I uploaded a YouTube video -- Urlaub auf dem Kapellenhof/Manderscheid - Ferienwohnung S... ~http 	neutral
Affiliate-with.me ist ein ausgetüftelter; funktionierender getesteter Plan (blueprint)  auf dem Weg zum Super Affiliate ~http 	neutral
Adidas Woman Fresh Escape Deo Body Spray; 150ml: Adidas Fresh Escape ist ein frischer; natürlicher Duft voller E... ~http 	neutral
Manche Bücher entfalten erst im Kamin ihr volles Aroma. (Manuel Vázquez Montalbán)	neutral
Diese Woche wird wohl mein neues Handy eintrudeln - Samsung Galaxy s2 - dann heists Bye Bye I Phone 3gs	neutral
Diven; Diebe; Diktatoren - SPIEGEL ONLINE - ~http	neutral
Hm. Vertrag kündigen und prepaid karte kaufen. Nicht nur bessere Kondition; sondern auch besserer Service. Traurig #o2	negative
Nie nie niemals wieder! Okay vielleicht doch	na
Trivial Pursuit aufm iPhone macht richtig Laune! Und das mir; dem Brettspielverweigerer!:  ~http 	positive
"gestern auf ""das vierte"": ""batman hält die welt in atem""... musste so lachen; dass ich mir direkt die dvd bestellt hab. morgen ist sie da"	positive
- Im Hungry	neutral
Für schlappe 260€ pro Tag kann man die Finca von Sonja Zietlow mieten...^^ ~http 	neutral
Bernd Eichinger hinterlässt eine unendliche Leere - ~http 	negative
"Der heutige Tag ist einfach mal... mistig. Man könnte ihn sogar als ""scheiße"" bezeichnen. Aber sowas tut man nicht."	negative
„Eine der seltensten Befähigungen ist die Befähigung; Befähigung anzuerkennen.“   -Internet	neutral
Jetzt muss ich nur noch wieder fit werden; damit ich zur mündlichen Prüfung kann &gt;.&lt;.	negative
"Naja.. Ich glaube Heute ist wieder mein ""OH SEBASTIAN!""- tag. @user  OOOOH SEBASTIAN! &lt;3 *O*"	neutral
Als Twitter noch meine Startseite war; hab ich wenigstens daran gedacht zu twittern.. Life..	neutral
Yummmmiii   RT: @user 500 g nutella für 0;99€ am Freitag (17.12.) bei Lidl bundesweit ~http	neutral
eingeschneit*	neutral
IM GUCCI 0N U YADIES! #divadoll	neutral
HEUTE ABEND AB 21 UHR KEYS ROCK ERÖFFNUNG MIT BBQ;SANGRIA;POOL SPIELEN;UND VIELEN WEITEREN ÜBERRASCHUNG ~http 	neutral
mein handy hört nach ein paar sms'n auf bei einer neuen sms zu vibrieren !	negative
Was soll man zu diesem TRailer noch sagen außer ... Möge die Macht mit euch sein: ~http	neutral
in der 10. runde geht er zu boden sicher # klitschko wins	neutral
äh LERNEN!	neutral
DAGEGEN! wurde gerade veröffentlicht! ~http  ▸ Titelthemen heute: @user	negative
finde keine Worte #Oslo #Utøya	neutral
Besten Dank für´s FOLLOW #FF an @user  @user  @user	positive
habe grade einen  waren freund zu gast	neutral
wird ja immer geiler hier.	positive
Rainbow Magicland ftw: D Auf zu den Achterbahnen!*___*	positive
E-Klasse brettern :D *.*	positive
Sehr geil... nicht gewusst das die noch produziert werden: Sony stellt Produktion von Floppy Disks ein ~http  via @user	positive
Dieses Video musst du dir ansehen! -- E Nomine--Psalms 23 (Parts 1&2) ~http  via @user	positive
Die Leute die am wenigsten über einen wissen sind immer die;die meinen;am meisten Ahnung von einem zu haben.	negative
grade iwie einsam...	neutral
Morgen Welt ....	neutral
So richtig leckeren Jackie und ne Frau wären jetzt echt schick. Und was ist? Red Bull Cola und Dvd gibt es nur. Lame...	negative
#Bundesregierung will weiterhin elektronische #Rechnungen ohne digitale #Signatur ermöglichen: ~http  #Heise	neutral
Sehr interessante Aufarbeitung Apple vs. Samsung bei Kollege RA Stadler: ~http 	positive
"#AB9720 ""Die technischen Probleme wurden wieder hergestellt; die Tanks sind leer."" :-)"	neutral
#bbde ingrid muss heute raus und am besten dann daggy^^	neutral
Rubber - Eine Hommage an die reine Willkür: ~http  #myconsol	neutral
So; wer bleibt denn noch als IDOL? #Loriot	neutral
Bei dem Wetter könnte nachher mit der Rasselbande mal auf den Spielplatz gehen.	neutral
Ich habe ein YouTube-Video zu meinen Favoriten hinzugefügt. -- Christian Siriano Fashi... ~http 	neutral
Ouhh Nintendo hat die offene Stelle des Head of Marketing neu besetzt. Rittinghaus tritt die Nachfolge von Schmidt an und er freut sich! (:	positive
Dexter hätte es nicht besser gekonnt ~http 	neutral
kann mir wer sagen warum adidas auf star was hangen geblieben ist? glaube nich das r2 d2 besonders sportlich ist! oder?	neutral
Cool echofon fürs iPhone unterstützt push:  ~http 	positive
krankes mädchen ist wieder zuhause .. will aber lieber wieder zurück ... zuhause ist kacke	negative
Ich habe ein YouTube-Video zu meinen Favoriten hinzugefügt. -- ich und ich - wenn ich ... ~http 	neutral
"Gerade ""Brücke nach Terabithia"" geguckt. So magisch und doch so traurig...."	positive
Hab mir eben einen Sony Ericsson Theme Creator runter geladen. Das Programm ist voll cool; da kann man sich eigene Hintergründe erstellen.=)	positive
Erstaunlich; dass manche Menschen so gar keine Vorstellung davon haben; was ihnen gut tut und was nicht. Jetzt: #fett #weg #ZDF	neutral
Hatte heute schon um 10:30 Uhr aus :P // Was machst du so?	neutral
Zu Hause |D Hunger; Klavier...und Hunger	negative
Die neuen Shark-Handys von Samsung passen ideal zu einem Streichelhai. Nicht wahr; @user ? Und Web 2.0 ist auch schon drin!  ;)	neutral
Apfelmuffins sind im Ofen! *yummy*	positive
"Der erste ""Nachblitzschlagtweet"" dank neuer Fritz!Box; das bei uns im Haus Fernseher und telefone gegrillt hat #Gewitter"	negative
#SuperSunday @user – angeblich verschlägt es ihr bisweilen die Sprache ... das kann ich nicht bestätigen! Krisenfest und humorvoll!	neutral
ääähhhmmm voll gefressen mit Chips und lecker Becks Lemon.	positive
alle bitte @user  folgen :D die freu ist einfach der hammer :D &´das ist die deutsche fanseite dazu :D	positive
Barbie und die 3 Musketiere in Bio geguckt ;D SCOOORE!	positive
Zensur bei Twitter; Facebook; Wikipedia & co.? Aufruf: ~http 	neutral
"kapo kaplan ft. h.u.s. ""froge"" ~http  @user @user @user @user @user @user #RT jetzt gehts:)"	neutral
Ab in die Sonne ;-) #summertime	positive
Daaa...Chilln und Supertalent gucken.	neutral
Hör dir Snoop Dogg von Signs an! Ich habe den Song gerade mit TrackID™ von Sony Ericsson gefunden.	positive
3cm - Dicker ist der neue 102cm LED-TV von Samsung leider nicht mehr! ~http	neutral
Bin grad dabei das erste Mal in meinem Leben ein Stück Fleisch zu braten!!!!	neutral
Nach der Erstellung des Charakters läuft das Intro; leider zwischendurch mit Aussetzern was den Sprecher betrifft und es fehlen Satzteile.	negative
würde dir gerne so viel sagen doch du bist leider weg.	na
Wir sollten alle mehr Freude empfinden. Meine Montagsgedanken dazu  ~http 	positive
Zum ersten mal ein Tweed von einem Apple gerät fühlt man sich gleich mehr in der gesellschaft akzeptiert	positive
mein hypothalamus hat immer noch keine follower in meinem grosshirn.	negative
Dieses Video musst du dir ansehen! -- Hölderlin - Requiem Für Einen Wicht (1972) ~http  via @user	positive
keini näme	na
De beruchte lach ~http 	na
vote für mehr #eigenverantwortung beim lernen; auch in schulen!! endlich spaß dabei und es bringt was!! #schulsystem #veraltet	neutral
"Ungläubig schüttelt der Richter den Kopf: ""Sie wollen allen ernstes behaupten; man hätte Sie zu dieser Strafta...~http "	neutral
Boa abfuck heute!	neutral
Okay; wo sitzt wohl der englischsprachige Microsoft Support?kleiner Tipp: hier sind kühe heilig und Arbeitskräfte billig	neutral
Tolle Tatorte am Tegernsee gesichert: Spielcasino; Bräustüberl; Büttenpapierfabrik; Wallberg. Die Spurensuche geht weiter!	neutral
Tanz mit mir; spiel mit mir; hab spaß mit mir ... Watch the moving bodies; as they react to the sound	neutral
Heute Abend ab wieder offener Jugendkeller im ALH =)	positive
#Frauen #WM Claudia Neumann hat gut kommentiert; viel Ahnung von Taktik. Das würde man sich von ihren Kollegen auch wünschen.	positive
Basic Thinking verschenkt das Samsung S7070. Ich will mit in die Lostrommel: ~http  #Divatelefon	neutral
Draussen sieht es tatsächlich nach so etwas wie *Sommer* aus.	positive
Wenn mich keiner faven will; fave ich mich halt selbst! So!	neutral
'Baddass headache ... whats goin on mann	na
in meiner küche sitzen menschen aus weimar; DIE ICH NICHT KENNE!	neutral
Die #Japaner verarschen uns und alle fallen drauf rein! ~http 	negative
Hier ein Leckerbissen aus der aktuellen Element KICK-BIKE Serie! ~http 	neutral
Das Samsung Wave ist doch auch eher ein Galaxy Fail; oder?	negative
Es qualmt und stinkt wieder im Hinterhof.Bis zum Ultimo muß der Betreiber nachbessern.Fettfilter fehlt seit Anfang an!Sauerei das ganze!	negative
Ist irgendwie schon beruhigend; dass es noch Probleme gibt; in denen ausschließlich ein Hammer weiterhilft und kein Hightechfirlefanz.	positive
Hallo; ich empfehle dir WhatsApp; eine tolle Messaging App für Smartphones. Chatten ohne SMS! Die App ist unter ~http 	neutral
Luxprivat zum Communiqué vun der @user zum Thema Anonymitéit am Internet: ~http 	na
Jeder 4. Deutsche bei Facebook. Pf! Jeder 2. MAD-Leser ist bei MAD-Tweets (1056). Macht 2112 Leser. Fazit: D hat gar nicht so viele Idioten.	neutral
Sicherheitsforum Baden-Württemberg: lesenswerte Studie zum Know-How-Schutz und Handlungsempfehlungen für Unternehmen: ~http 	neutral
"Hotel Tipp: ""the first boutique hotel in Santa Marta..."" ein optischer Leckerbissen :) ~http  #Kolumbien"	positive
Wenn du jeden Tag denkst es waere dein letzter; wird der Druck irgendwann unermesslich.	negative
Ich glaube; ich schule um. Zum ignoranten Flittchen ^_^	na
Hergeschaut! Nintendo 3DS – ausgepackt! ~http 	positive
2010 DeLorean Nike (via @user). Gibt's ein Hoverboard dazu?	neutral
Endlich in Deutschland mobil online und auf android 2.2	neutral
DREI ECHTEN VON ~http  Echte Kroatzbeere verwöhnt seit hundert Jahren zahlreiche Genießer mit der... ~http 	neutral
Sehr gut! RT: Twitter verhandelt m. Google & Microsoft über Tweets in  Suchergebnissen. Computerbild: ~http  @user	positive
Blöde Vettelwirtschaft.	negative
1500 Kilometer; 23 stunden wach und davon 22 1/2 stunden on tour. Ich bin platt. Gute Nacht	neutral
Wir sollten alle mehr Freude empfinden. Meine Montagsgedanken dazu  ~http 	neutral
Morgen Lang Arbeiten Und Akustik-Gitarre Reparieren (;	neutral
Warum wundern sich alle; das die Linke Castro bewundert? Immerhin hat der nicht nur eine Mauer um sein Land gebaut; sondern ein ganzes Meer!	neutral
Wir sollten alle mehr Freude empfinden. Meine Montagsgedanken dazu  ~http 	neutral
Liebe #Läufer. Seid Ihr eigentlich auch schon mal einem Beinschleuderer begegnet? #nurmalsogefragt ~http 	neutral
Leider hält Glück meistens nur so lang wie eine Seifenblase.	neutral
SecondRadio.de wird die 5-jahres Feier von SLInfo unterstützen. Wir sind stolz; Teil dieser Community zu sein! ~http	positive
"Endlich; der ganz besondere Kindersparplan mit Wunscherfüller-Garantie - ""MV Stark wie ein Tiger"" ist da! ~http "	positive
heut erstma voll fett 6 stunden rad gefahren	positive
Mit einem schnellen; gekonnten Schlag zerbrach dem Ei sein Genick.	positive
Betäubung hält 4 Stunden . Ich hab jetzt schon Hunger !	neutral
Jetzt heißt es endspurt beim @user - denn heute muss die abschluss-sendung fertig werden. Wirds dann online geben.	neutral
Der Abzug des Holzkohlegrill in seiner vollen Schönheit.Viel zu kurz geraden;und zu nah an der DG Wohnung nebenan! ~http 	negative
Buchon : persona de buche grande	neutral
